###########
#     # # #
### # # # #
#   #     #
# ####### #
# #   # # #
# # ### # #
# #       #
# # ### ###
# #   #   #
###########
