###########
# # # #   #
# # # # # #
#   # # # #
# ### ### #
#   # #   #
# # # # # #
# #   # # #
# ####### #
#         #
###########
