#####################
#             #     #
### ### ####### #####
#   #         #   # #
# ####### ### # # # #
#       # #     #   #
####### # ######### #
# # # # # #   #     #
# # # # # ### ##### #
#   #   #     # #   #
### ####### # # # ###
# # #       #   # # #
# # # ####### ### # #
#       # # # #     #
# # ##### # ####### #
# #           # #   #
# ########### # #####
# #   # # # #     # #
### ### # # # ### # #
#             #     #
#####################
