#####################
#             #     #
### ##### # ##### # #
#   # # # #   #   # #
# ### # # ### ##### #
#   #       # #     #
### ######### ### ###
#     # # #   #     #
##### # # # ### # ###
# #       #     #   #
# # ### ##### ##### #
#   # # #     #     #
# ### # ######### ###
# # #   #       # # #
### # ### ### ### # #
#   # # # #     #   #
# # # # ####### ### #
# #   # #     # # # #
# ### # # # ### # # #
# #       #   #     #
#####################
