###################################################
#     #               #     #       #   #     #   #
# # ##### ######### # # # # # ### ### ### # # # # #
# #   #   #   # #   #   # # # #           # #   # #
# ####### ### # # # ### # ### # ########### ##### #
# # # # #   #     # #   #   # # # #       # # # # #
# # # # ### ### # ##### # ####### ### # ### # # ###
#     #     # # # # #   #   #       # #     # #   #
# ##### ##### # ### # ##### # ##### ### ##### ### #
#   #       # # #   #   #   #   # #         #   # #
### ### # ### ##### ####### # # # ### # ##### # # #
#   #   # #     # #   #   #   #   # # # # #   #   #
# ### ##### ##### # ##### ##### # # ### # # ### # #
# #       # # #     # # #   # # #   # #   #   # # #
# # ##### # # # ### # # ### # ### # # ##### # #####
#       #       #   #   # #       # # #     #     #
# ##### ######### ### # # ### ### # # ##### ### # #
#     #     #       # # #   #   # #       # #   # #
# ####### ### ### ##### ### # ### ####### # ##### #
#   # #   # #   # #   # # #   #     # #       #   #
# # # # ### ### # # ### # # ### # # # # ### ##### #
# #   # #   #   #         #   # # # #     #     # #
##### # # ### ##### ### ### ####### ##### ### ### #
# #   # #     #   # #   #   #         #   #     # #
# ##### ##### # ### ##### ### ########### ### # ###
# #     #     # #     #   #         #     #   #   #
# # ##### # ### # ####### ### ### ####### ### ### #
#     # # #     #       #   # #     #     #   #   #
# ##### ######### ### ### # # ##### ############# #
#     #           #     # # #   #               # #
# ######### ################# ##### # ####### # # #
#     #     #     # #     # # #   # # #   # # # # #
### ##### ##### ### ##### # # # ####### ### ### # #
#   #   #   #     # #   #     # # #         # # # #
# ##### ######### # # ##### ### # # ### ##### # ###
# #           #       # #   # #     # #         # #
# # # ####### # # # ### ### # ##### # # ##### ### #
#   #     # #   # #   #     #     # #   #   #     #
# ##### # # # ######### ######### # ### # ####### #
#   #   # # # #     #           # # #     # # #   #
######### # # # ### ####### ##### ######### # # ###
#   #       # #   #       #   #     #   #         #
# ### ### ### ##### ##### # # ### # # # ### #######
#       #   # #     #       #   # # # #     # # # #
### ######### # ##### ### ####### # # ####### # # #
# #     #     #   # #   #     # # # # #       #   #
# ##### ##### ### # # ####### # ### # # ##### # ###
#   #     # #   #   # # #   #   #       #   #     #
# ### ### # ### ##### # # # # ##### ### # # ##### #
#     #     #     #   #   #       # #     #     # #
###################################################
