###########
#         #
##### # # #
# #   # # #
# # ##### #
#       # #
# ### ### #
#   #   # #
### ### # #
#   #   # #
###########
