###################################################
#   #   # #       #       #   #           #   #   #
### # # # ### # # # ######### ### # ### # # # ### #
#     # #     # # #       #   # # # #   # # # # # #
# ### ##### ######### ### # ### ### # ##### ### # #
#   #     #   # #     # #     #   # # #       #   #
### ### # # # # ##### # ### ### ### # ##### # # ###
#     # # # # #       #   #   #     # #   # #     #
# ##### ##### # ####### # # # # ### # ### ### #####
#   #       # #   #     # # # # #   #     #   #   #
##### ##### # ### ### ### ### ########### # # ### #
#     # #   #   #   #   # # # # #   #   #   # #   #
# ### # ##### ##### ##### # # # # ##### ##### # # #
#   #         #   # #       # #       #     #   # #
##### ##### ### ### ##### ########### # ##### #####
#   # #   #     #       #   #       #         #   #
# # # # ##### # # ##### ### ### # # ##### ####### #
# #     #   # # #   #         # # #   #       #   #
##### ### # # ##### # ######### # ####### # # # # #
# # # #   #     #   #           # #       # # # # #
# # # # # ######### # ############# ######### ### #
# #   # # #     #   #     # #   #     #     #   # #
# ### ##### ##### ####### # ### ########### # # # #
#         #     #       #                 # # #   #
####### ##### ##### ### ####### # ### ##### # ### #
#     #         #   #   #   #   # #     #     # # #
# ##### ########### # ##### ##### ##### # ##### # #
#   #     #     #   #   #   #         # #     #   #
# ### ### ##### # ### # # # # ####### ##### ##### #
#       # # #     #   #   # #   #       # # #   # #
# ### ### # # # ### ##### ### ####### # # ##### # #
#   #   #     # # # #     #     # #   # # #     # #
# ##### ##### # # # ####### ### # # ##### # ##### #
#     #     # # # #       # # # #         #       #
### # # ####### # ########### ##### ####### # ### #
# # # #     #   #   #       # #             # #   #
# ########### ##### # ### ### # ### # # ##### ### #
#         # #   #       # #   #   # # #     # # # #
# ##### # # # ####### # ##### ####### ##### ### # #
# #   # # # #       # #     # # # # #   #   # #   #
# # ### # # # ### # ### ### # # # # # ##### # ### #
#     # #     #   #       # #   #   #     #   #   #
########### # ##### # ### # ### # # ##### # # #####
#   #   #   # #     # # # # #   # #   #   # #     #
# # ### ##### ### ### # ### # ##### # ### ### ### #
# # #   #     #   #     #     # #   #   # # # # # #
# ##### # ########### ##### ### ##### ##### # # ###
#   # #     #     #   # #   #     #     #     #   #
# # # # ### ##### # # # # ### # # ### # # ####### #
# #     #         # #   #     # #     # #         #
###################################################
