#####################################################################################################
#         #               #                 #   #         #             #       #   #         #     #
######### # ##### ### # # ### ##### # ### # ### ##### ### ######### ##### # # # ### # ### ##### # # #
#   # #     #   # #   # #       #   # # # #     #   #   # #         #   # # # # #   #   # #     # # #
### # # # # # ### ########### # ####### # # ####### ### ##### ####### ##### # ##### ### ### ### #####
#     # # #   #     #     #   # # #       #     #     #       # #     #     #     # #       # # #   #
# # ##### ### # ##### ### # ### # # ### ##### # # ##### ##### # ### ##### ####### # # ####### # ### #
# #   # #   # #     #   # #   # # #   #   # # # #       # #         #         #   #   #       # #   #
### ### ### ### # ##### # ### ### ### # ### ### # # ##### # # # ####### # ######### ### # # ### # ###
#           # # # #     # #   # #   # # # #     # #     #   # # #   #   # # # #       # # # # #     #
####### ### # # # # ### ##### # ### # ### ### ### # # ########### ### ### # # # # ##### ##### ### # #
#     # # #   # #   #     # # # # # # #     # #   # # #   #   # #     #     # # #   # #       #   # #
##### # # ##### # ### ##### # # # # # ##### ### ##### # # # # # # ##### ##### # ### # # ##### ##### #
#   #     #     # #   # #   # #     # #     #     #     #   #       #   # #   #   # # # #         # #
### ### ### ####### ### ### ### ####### ##### # ##### # ####### ### ##### # ### # ### # ##### ### # #
#   #   #         #       #   #   #   #     # # # #   # #   # # #       #       # #   #   #   #   # #
# # ##### ### ### ######### ##### # ##### # ### # # ### ### # # ##### ### # # ####### # # # # ##### #
# #       #     #   #         #     #     #   # #   # #   #         #   # # # # #   #   # # # #     #
# ################# ######### ### # # ##### # # ##### ### ######### ####### # # ### ##### ######### #
# #       #     #                 # #   #   # #   #     #   #   #     #     #   #   #       # #   # #
# # ########### ####### ##### ##### # # ##### # ##### ######### ### ### # ### # ### ####### # ### # #
# #         #   #       # #       #   #     #   # # # #       #   # #   # #   #       #             #
# ### ##### ### # ####### ####### # ####### ##### # # # ##### # ##### ### # # ### ### ### ##### #####
#   # #   #           # #     # # #   # #   #   #         #   #         # # #   #   #   #   #   #   #
# ##### ####### # ### # # ### # ##### # # # # ### # ### ########### ##### ##### ### ### # ##### ### #
# # #   #       # # #       # #   #   # # # #   # # #           #     #     #   # # # # # #   # #   #
# # # ### ### # # # ### ### # ### # ### ##### ### ##### # ############# ### ##### # # ##### # # ### #
#   #   #   # # #   #   # # #   #   # #     #         # #   #           #     # # #   #     # #     #
# ### # ##### ### ### ### ####### # # # ####### ### ##### ### ####### # # ### # # ####### ####### # #
#     #     #   #   #   #       # #   #   # # #   #   #   #     #   # # # #     #   #   #       # # #
####### ### ### ### ### ### ### ##### # # # # ##### # ##### # # ### ### ####### # ### ##### ##### # #
#     # #   # #   # # #   # #           # # #   #   #   # # # #       # #   #   #   #   # #     # # #
# ##### ##### ### ### ####### # ##### # # # ### # ####### ############# ### # # # ##### # # ### # # #
#   # # #     #     #     #   #   #   # # # #         #       #     #     #   #           #   # # # #
# # # # ### ######### ##### # ### ##### ### ### # ########### # # ### # # # ### # ##### # ### ### # #
# #   #     #   #   #     # # #   #     #   #   #   #     #     #     # # # # # # #   # #     # # # #
# # ####### ### # # ### # ##### ####### # # ####### ##### ### # ######### ### ##### # ######### ### #
# #     #     #   # #   #     #   # # #   #   #   #   #       #   # # # # #     # # # #             #
##### ### ### ### ##### ##### # ### # ### # ### ### # ##### ####### # # ####### # # # ########### # #
#       #   # # #       # # # # #       # #         #   #     # #             # # # # # #       # # #
### # ### ##### ##### ### # # ####### ##### ### # ##### # ### # # # ##### # # # # ### # ### ##### # #
# # #     #           # # #             #     # # #   #   # #     #   #   # #     #   # #         # #
# # ########### ### ### # # ### # ### ############# # # ### # ######### ####### # # ### # # # # # # #
#         #   # #     # #   #   # # # #   # # #   # #     #       #   #   #   # # #     # # # # # # #
# ####### # # # # # ### # ### ### # # # ### # # ####### ####### # # ##### ### ##### # ########### # #
# #         #   # # #   # # #   # #               #     # #   # #   #       # # #   # #   #       # #
# ####### ### ### # ### # # ##### # ######### # ####### # # ### ##### ####### # # # ##### # ### #####
#   # # #   #   # #     # # # #   #         # #     #   #     # #   #   #     #   # #     #   #     #
# # # # ######### ##### # # # # ######### # ### ########### # ### # ### ### ### ### # # ####### #####
# # # # # # # #     #   # #   # #       # #   #   # #       #   # # #   #   #   # #   #   #   # #   #
### # # # # # # ### # # ##### # ### ### ##### ### # # ### # # # # # # ### ### # # ### # ### ### # ###
# #   #       # #   # # # #       #   #   #   #     # #   # # #   # #   #     # #     # # #   # # # #
# ### ### # ### # ##### # # ### ####### # ####### # ### ### # # ######### ######### ##### ### # # # #
#   # #   # # # # #   # #   #       #   # # #     # #     # # #   #   #         #     #           # #
# ######### # # ##### ####### ### # ##### # # # ### ### # # ### # ### # ########### ### ##### # ### #
#   # # # # #       # #     #   # #     #     #   #   # # # #   #       #           # #     # # #   #
### # # # # ### ### # # # ########### ##### ######### # # ######### ######### ####### ####### # ### #
# #             #   # # # #   #     # #   #   # #   # # # #   # #   #   # #   #     #       # #   # #
# # ### # ####### ### # ##### ### ####### # ### ### # # ### ### # ##### # ### # ####### ##### ##### #
#     # # #     #     #   # #       #       # # #         #     #     #     # #       # #   #   #   #
# # # ##### ### ##### # # # ### # ### ##### # # ####### ####### ##### ##### # # # ### # ### # # # # #
# # #   # # #   # #     #   # # # #     #         #     #             #       # #   # #   #   #   # #
# ####### # # # # # ######### # # ##### ### ### # ### ##### ### ### ### ####### ##### # # ######### #
# #   # #   # #   # #       #   #   # # #   # # # #       # # # # #   #   # #     #     #     #     #
# # # # # ### ######### # ### ##### # # ##### ####### ### # # # # ##### ### ##### # ### ########### #
# # #     #         # # # # # #   #     # #       #   #   # #   #   #     # #     # #   # #   #   # #
# ####### ######### # # ### # # ####### # ### ### # ####### # # ### # ### # ### ####### # # # ### # #
#   #   #       # #   # #   #     # #   # #   #       #   # # # #       #   #   # # #   # # # #     #
# # # # # ##### # ##### # # ##### # # ### # ### ### ### ##### # ######### ### ### # # ### # ####### #
# # # #   #   #       #   #       #   #   # #     # #   #   # #     # #             #       # # # # #
# ### ### ### ######### ### ########### ### ### ### # ### # ######### ### ############# # ### # # # #
#       # #       #       #       #         #     #       # #           #     # #       #       #   #
# ### # # # ##### ######### ######### ########### ####### ### ### ##### # ##### ############### ### #
# #   # # #   #   #   # #     # # #     # #           #   # # #   #     # #   #     # # # #     # # #
# ##### ##### # ##### # # ### # # ### ### ### ######### ### # # # ##### ##### ### ### # # # ##### # #
#     # #     # #     #   #     #           #         #     # # # #     #   # #       # # #     # # #
##### ######### ##### # ##### ########### ##### # ##### # # ##### ####### ### ### ##### # ##### # ###
#   # #           #   #   #   # #   #   #   #   # #     # #       #   #             # #     #       #
### # ### ### # ##### ######### # ##### ### ##### ### ##### ### # # ### ######### # # ### # # # ### #
#   # #   # # # #   #       # #     # # #   # #   # # # #     # #   # #   #     # # # #   #   # #   #
# ### # ### ####### ####### # ##### # # # ### ##### # # ####### ##### ### # # # ##### # ### #########
#     # # #     #       #       #   #   # #     #     # #     # #         # # #       #   #         #
# ##### # ### ### ### # # ##### # ### ######### # # # # # ### # # ### ####### ####### ######### ### #
# #     # #   # # #   # # #   # #     #   #     # # # #   #     # # #   # #         # # #         # #
# ##### # # # # # # ##### ### # ##### # ### ################# ##### # # # ##### ### # # # ##### #####
# # #     # # #   # # #       # #   #             # #           #     #     #   #   # #   # #       #
# # # # ### # # ##### ### ##### # # # ####### ##### # ####### # # ##### ### # # ########### ### ### #
#   # # #   # #       #   #     # #   #   #   #     #   #     #   #   # #   # #             # # #   #
# ### # # ##### ##### # ####### # # # # ### # ##### # # ########### ### ##### ############# # ##### #
#   # #       #   #   # #         # #   # # # #   #   #     # #   # #       # #   #       #     # # #
# ########### # ### # ### ############### # ### ####### ### # # # # # ##### ### ### ### ##### ### ###
#                 # # #     #   #     # #     # #       #   #   # # #   #   #     #   #       #     #
# ########### # ######### ##### # ### # ####### ##### ### ### ### # ##### # # ### # # ######### ### #
#       # #   #   #   #     # #   #       #         #   #     # # # # # # #   #     #     #     #   #
####### # # # ### # ##### ### ##### # # ##### # ##### ### ### # ### # # # ####### ####### ### ##### #
#       #   # # #     # # #     #   # # #     # #       # #         #   # #   # # #   #   #   #     #
# ######### ### ##### # # ### ##### # ### # # ### ### ######### # # # ### ### # # # ### ### # ### ###
# #   #   #       # # #         #   #   # # # #     # #   #     # # # #   #   #   # #       # #     #
# ### # # ### # ### # # # ### ### # ### ### ### ### # ### ##### ### # ##### ### # # # # ##### #######
#       #   # #   #     #   #     #   #       # #   #       #   #           #   #   # # #           #
#####################################################################################################
