#####################################################################################################
#           #     #   # #     # # #       #   #       #   #       #           #         #     #     #
### ### ##### # # # ### ### ### # ##### ### ####### # # ### # # # # # # # ############# # # ####### #
#     #     # # #   #     # #     # #         # #   #   #   # # # # # # #       #       # # # #     #
# ####### # ### ##### ##### # # # # # ##### # # # ##### ### ####### ####### ### # # # # # # # # #####
# # # #   #   #     #         # # # #   # # # # #   #   #     # # #   #     # # # # # # # #         #
# # # ####### # ############### ### # # # ### # # ####### ### # # # ######### ### ### # ##### # #####
#           #   #   #   # #   #   # # # #   # # # #     #   #         # # # #       # #     # #     #
### # ##### ### # ##### # # ##### # ### # # # # # ### # ##### # ##### # # # # ############# ##### ###
#   #     #   # # #   # #         # # # # # #         # #     #     #   #     #       #   # # #     #
##### ##### ### # ### # ######### # # ### ##### ######### # ### ##### # # # ### # # ### ##### # ### #
#   # #   # #         # #         # #           # #   # # # # #   #   #   # #   # # #   # #       # #
# # # ### ##### ####### # ### ### # ########### # ### # ##### ####### ##### ### ### # # # ### ##### #
# #       #   #     #       # # #   #           # # #       # # #       #     #   # # # #     #   # #
# ### ### ### ########### # # # ### # ##### ### # # ### ##### # # # # ############# # # ### # # # # #
#   #   # # # #       #   # #     #     #   # #   # # # #       # # #               # # # # # # #   #
### ### # # # ### ### ####### # ##### ####### ##### # # ### # # # # ######### ### ##### # ######### #
#     # #     #   #         # #     # #       #   #         # #   # #     # # #       #       #     #
# ##### ##### # # ##### # # # ### # ### ######### ####### ####### ### ##### ### ########### # ##### #
#   #   #       # #   # # #   #   #   #       #       # #   # # # # # #       # # #         #     # #
# ##### # ### ##### ### ####### ### ####### ### ### ### ### # # ### # ####### # # # ##### # # ### # #
#     # #   # # #   # # #   # #   # # #   # #     # #             #   #     # # #     #   # # # #   #
### ######### # # ### # ### # ####### # # # # # ##### ### # ####### ### ### # ### ### ### ##### ### #
#     #     #   #               # #   # #   # # #   # # # #             #   #   #   #   # #   # #   #
# ####### ##### ############### # # ##### ### # # # # # # ################# ### # # ####### # # ### #
#   #     # #     # #         #     #   #     # # # # #             #       #     # #   #   # # # # #
# ### ##### # ##### # # ############# ##### ### ### ### # ############### ##### # ### ### ### # # # #
#   #   #       #   # # # # # # #         # #   #     # # #       # #   #       #   #       # #   # #
# ##### ##### ### # # ### # # # # # ### # # # ##### ####### # ##### # # ### ##### ####### # ### # # #
#   # #   #   #   #         #   # # # # # # #       #     # #       # #   #   # # #     # # #   # # #
# # # ### # # # ####### ####### ### # # ##### ##### # ### # # ##### # ### # # # # # ### # # # # # # #
# # #     # #         # #     #   # #   #   # # #       #   #     #     #   #   # # # # # #   # #   #
# ##### ####### ##### # ##### ### # ##### # ### ### # # ##### ### ####### ######### # ##### ##### ###
#     #     #   #     #     #         #   #     #   # # #     #   #     # #     #     #       # # # #
# ####### ### # ####### # ##### ####### ########### ### # ### ##### ### ##### # ### ### # # ### ### #
#   # #       # #   #   # # #     #   #       #   #   # # #   #     # # #     #       # # #   #     #
##### ### ##### ### # ##### # ### # # ### # ### # # ### ##### # # ### # # ####### # # ####### ##### #
#   #     # #     # #   #       #   # # # # #   #     #   #     #   #     #   #   # # # # #         #
# ####### # ##### # # ### ### ### # ### ### ### ######### ##### ########### # ####### # # # #########
#       # #   # # #     #   # #   #   #           #   #     #     # #   #   #     #   #   # # # #   #
# ### ### # ### # # ##### ### ####### ##### ##### ### ### ##### ### # ### ##### ##### # # ### # # # #
#   #   #   # #   # #     # # #     # #     # #   # # #   # #       #       #   #     # # # #   # # #
# ### # ### # ### ### ### # ####### # ### ### ### # # # ### ### ##### ### # ##### ####### # # ### ###
#   # #     # #       #       # #     #     # # # #         # # #   #   # # #   #   #       #       #
######### # # # ##### ##### # # ####### # ### # # # ####### # ### ##### ### # # ### ### ######### # #
#   #   # # #   #       #   #   #       # #       #       #   #     # #   # # #   #     # #       # #
# ### # ##### ######### ### ### ##### ####### ############### ### ### ##### ##### ##### # ##### ### #
# # # # #     # # # #     # # #     #   #         #     #   #   #     #           # #   #   # # # # #
# # # # ####### # # ##### ### ##### ### ##### # # ### # # ##### # ### # # ####### # ### ### # ### # #
# #   #   #   #   #           #   # # # #   # # # #   #   #       # #   #   # #   # #   #         # #
# ##### # ### ### ### ####### ### # # # # ##### # # ### ### ### ### ### # # # ### # ### ### # ### # #
#     # #   # #   # #   #     # #   #   #   #   # # #   # # #   #   #   # #     # # #       # # #   #
# ##### ##### ### # ##### ##### ### ### ### ### # # ##### # ### # ### ######### ### # # ####### # # #
#       # #   #   # #   #   #   #   #     # #   #     #   #   # #     #     # # #     # #         # #
### ##### # ### ### # # # ### ### # # ##### ##### ### ### ### ######### ### # # ### # # ##### # ### #
#       #     # #   # #     # # # #           #   #     # # #       #   #   #   #   # #   #   # # # #
####### # ##### # # # ### # # # ### ######### ### ### ### # ####### # ### # ### # # ##### # # ### # #
#   #             # # #   #     #     #   #   # #   #       # #     #   # # #   # #   #   # # #     #
# ######### ### # ##### ##### ##### ##### # ### # # ##### ### # ### ### # ####### # # # ### ### # # #
#     #   # #   #           # #   #     #     #   #   #       # #       # # #     # # # # #   # # # #
# ### ### # ### ##### # ### # # # # # ##### ### ####### ######### ##### ### ##### ####### ### # # ###
#   # #   #   #   # # # #   # # # # # # #   #   # #   # #   #   #   # #       #     # # #   # # #   #
##### ### ### ##### # ### ##### # ##### ######### ### # ### # ### ### ### # ### ### # # ### # #######
#   #   # #     # #   #       # # # # #   #         #   #         # #     #   # #     # # #         #
# # # # # # # ### # ####### # # # # # # ### # ##### ##### ### # # # # ####### ####### # # ### #######
# # # # #   # #     #       # # #   #       # #     #   # # # # # #   #   # # # # #     #   # # #   #
# # # ### # ### ### ####### # ### # # # ##### ### ### # ### ### ### ##### # # # # ### ### ### # # # #
# #   #   # #     # # #   # #   # # # #   #   #   #   # # #   # #       #   #   # #       #   #   # #
### ### ### ####### # ### ##### # ##### ### # ### ### ### # # ####### # # ### ### # # ####### # ### #
# #   # #         #         #   #       #   # #       # #   # #       #   #       # # #   # # #   # #
# # ### ####### ####### # ### ##### ##### ### ### # ### ##### ####### ##### # ### ### # ### ####### #
#     # # # # # #       #   # #       #     #   # #   # #               # # # # #   #         #     #
### # ### # # ##### ####### # # ########### ########### ####### ### ##### # # # # # ######### # # # #
# # #     # #   #         # #       #     #         #     #     #   # #     # # # # # # # # # # # # #
# # ### # # # # # ####### # ####### # ### ### ### ##### # # ##### ### ##### ### # ### # # # # ### # #
#   #   # #   #     #     # #     # # #         #     # # #     #       # #     #         #   #   # #
### # ### # ##### ##### ### # ##### # ############# # # ##### ######### # ### ### ##### ######### ###
#   # #   #   # #   # #   # #   # # #     #     #   #     #   #     #   #       # #   #       # #   #
# ####### ### # ##### # # # # # # # ##### # ##### # ### # # ### # ####### # # ####### ##### ### # # #
#       #   #       #   # #   # #   # #     #   # # # # # #   # #   #     # #         #   # #   # # #
# ######### ### ########### # ##### # # ####### ##### # ####### ### # ################### # ### # # #
# #         #   # # #   #   #     #   # #         #   # #   #     # # #             #   # #       # #
# ### # # ##### # # ### ############# ### # # # ### # # # # ### # ##### # ####### # ### # # ##### # #
#   # # # # #   #     #         #   # # # # # # # # #     #     # #   # #     #   #       #   #   # #
##### ### # ### ### # # # ####### ##### # # ### # ### # ##### ##### ######### # # # ### ####### ### #
#   # #       #   # # # #   # #           # #       # #     # #               # # # # #     # #   # #
### # ### # # # ### # # # # # ### # ##### ######### ### ### ####### ############# # # ####### #######
#   # # # # #   #   #   # #   #   # # #   #   #   # # #   #       # # # # # #     # #     # # # # # #
# ### # # ### ### # ##### ### ##### # # ##### # ### # ##### ####### # # # # # ##### ##### # # # # # #
#   # # # # # #   # #   #   # #     #       # #   # # #   # # #     #     #       # #     #         #
### # # # # # ######### # # # ### ##### # # # # # ### # ### # # ####### # # ##### # # # ### ####### #
# #   # #   #   #   #   # # # #   #   # # #   # # #   #   # #       # # # # # #   #   # #   # # # # #
# # # # ####### # # # # # ### # ##### ####### # # # ##### # # # ### # # # # # ############# # # # # #
#   # #       #   # # # # # # #   #       # # # #     #     # #   # # # # #   #   # #   # #     #   #
# ### # # # ##### ### ### # ### ### ####### ### ##### ######### # # # # ######### # ### # ### #######
#   #   # # #   #     #         #         #   # #               # #     #   #       # #     #       #
# ### ### # ### ### ### ### # # ######### # # ####### ############# ### # # # ##### # # # ####### ###
# #   #   #   # #       #   # # # #   # # # #         #       # #   #     #   #     # # #       #   #
# ### ####### # ##### # ######### # # # # ### # ####### ####### # ### ### ### ### # # # ### # ### # #
# #         #   #     #             #         #                 #   #   # #   #   #       # #     # #
#####################################################################################################
