###################################################
#     #   #     # #       #     # #             # #
# ### # # ##### # # ####### # # # # ####### ##### #
# # #   # #     #   #       # # #   # # # #       #
# # ##### # ##### ##### ### ####### # # # # ##### #
#       #   # #   #   # # # #     #   # #   #     #
# ##### ##### # # # # ### # ### ##### # ######### #
#     #         #   #               #   #     #   #
### # ### ##### ##### ##### # ### # # # # ### ### #
#   # #   # #     # # # #   #   # #   #   #   #   #
# ######### # ##### # # ### ### # ### ######### # #
#   # #   #       #       # #   # #   # #   # # # #
### # # ### ### # ### ##### ##### ##### ### # # # #
# # #     # #   # # #     #   #     # #   #     # #
# # # ##### # # ### ##### ### ##### # # ####### ###
#   #   #   # #     #   # #   #     #       #   # #
# ##### ### ######### # # ############# # ### # # #
#   #   #   # #       # #   #     # #   #   # # # #
# ### ### ### # # ####### # # ##### ### ### ##### #
#   #           # #   # # #         #   # #       #
### # ### ### ### # ### ##### # # # # # # ##### ###
#   # # #   #   #       #     # # #   #   #       #
# ##### # # # ##### ####### ####### ### ### ### # #
# #     # # # #   #   #     #   #     #   #   # # #
# ##### # # ##### ### ### ### # # ############# ###
#       # #   #   #     #   # #           #   #   #
# ####### ### # # # ####### ##### ### ##### ##### #
#       #   #   # #   #   #   #   #   # # #   #   #
# ######### ### ####### # # ######### # # # ### ###
# # #         # #   # # #   #   #   # # #         #
### ######### ##### # # # ##### # ##### ### ##### #
#       #   # #   #   # # # #   # #       # # # # #
# # ### ### # # ##### ### # ### # # ### # # # # # #
# # #         # #   #         #     #   # # #   # #
### # # ### ### # ####### ######### ##### # # # # #
# # # # #       # #   # #     #     # #   # # #   #
# # ##### ####### # ### ### ### # ### ### ####### #
# # #         #       # #   #   #   #       #     #
# ### ##### # # ##### # ##### ##### ### ######### #
#     #     #     # # #       #     # #     #     #
# ### ### ##### # # ### ### ######### ##### #######
#   # # #   #   #   #   # #   # # #       # #     #
# ### # ########### # ### ##### # # ### # # # ### #
# # # # # # #   # # #   #         # #   # # # #   #
# # # # # # ### # # # # ##### # # # # ##### ##### #
# # #     #       # # # #   # # #   #   # # #     #
# # ### ##### ##### ### # # ######### ### # # # ###
#     #     # #       # # #       #   #   #   #   #
# ####### # # ####### # # ### # ### # # ### ##### #
#     #   #       #       #   #     # #     #     #
###################################################
