#####################################################################################################
# #       #       #             #   #     #                 #     #       #   #   #       #     #   #
# ##### # # ### # ########### # # # ### ##### ##### ####### ### # # # ### # # # # ##### ####### # # #
#       #     # # #           # # #   #       #     #     # #   #   # # #   # # # #   # #         # #
# ##### # ### ##### ##### # ### # ### # # ############# ### # ### ### # ##### ### # # # ########### #
#     # #   # #   # #   # #   #   # # # # #   #     # #     # #     #   #     # # # # # #     #   # #
####### ##### ### # # ##### ### ### # # ### # # ##### ##### ##### ### ### ### # # ### # # ### # # # #
#   #     #   #   #       #   # #       # # # #   #     #     # #   #   #   # # #     #     # # # # #
# ##### # ##### ### # # ### # # # ##### # # ### ### # ####### # ### ### ### ### # ####### # # # # # #
#   # # # #       # # # # # # # # # #       #   #   #   # #   # #     #   #         #   # # #   #   #
# ### # # ##### ##### # # # # ### # ### ####### ### ### # ### # # ### ############### ########### ###
#       #             # # # # # # # #   # #         #   #       # # #   #   #     #   #       #     #
# ############# ####### # # # # ### ### # ####### ### # ####### # # # # # ##### ##### ##### # # # # #
# # # #   # #   #     # #   # #   # # #     #     # # # # # #     # # # #   #   #     #   # # # # # #
# # # # ### # ### ### # ##### # # # # ####### # ### # ### # ####### # ##### ### ##### # ##### # ### #
#   # #     # #   #   # # # #   # # # #       # # # #   #       #     # #   # #   #     # #     #   #
# ### ##### # # ### ##### # ### # # # # ### # ### # # ##### # ### # # # # ### # ####### # ### ### # #
#           #   # #           # #   # #   # # # #       #   # # # # # #   #   #   # #     #   #   # #
######### # ##### # ############### # ##### ### # # # # # ##### ### # ### # # ### # # ### # # # ### #
#     # # #   #   #     # #   #   #   #     #     # # #     # #   # #   # # #   #     #     # # #   #
### # # # # ##### # ##### # # ### ### # ### ##### # ######### # # # ##### ### ##### # ### ##### # ###
# # #     #   # # # #   #   # #   #       #     # # #         # #     #             #   #   #   # # #
# ### # ### ### # ### # ### ### # # # ####### # # ######### ####### ##### ### ##### # # ##### ### # #
#   # #   #   #   # # # #   #   #   #   #   # # # #   # # #     # #   #     #     # # #     # #     #
### # ##### ### # # ### ### # ### ##### ### # ####### # # # ##### ############# ####### ### # ##### #
# #   # #       #   # #   # # #     # # #         #   #   #     # #       #   # #     # #   #   # # #
# # # # # ### ##### # # ### ##### ### # ##### ### # ### ### ### # ##### # ### ##### # ### # # # # # #
# # #   #   # # #   #       #   # #   #     # #               #   # #   # #         #     # # #   # #
# # # ####### # # ### ### ### # ### ####### ### # ### # ##### ### # # ##### # ##### ####### # #######
#   # #     #   # #   # #   # # # # #       #   # #   # #       #   #       # # #   #     # # #   # #
### ### ##### ######### # # ### # # # ### ### ### ####### # # # ##### # ####### # ### ##### ### ### #
#   #       #   # #   # # # #         # # #   # #   #   # # # #       #   #     # #       # #       #
# ######### ### # ### # # # # # ### # # ####### ### ### ####################### # # ### ####### ### #
# # # #         # #   #   #   # #   #       #   # # #       #             #   # # # # # #   #   #   #
# # # ######### # # # # ### ##### ########### ### # # ### ### ########### # ### # # # # ### ##### ###
#       #         # #   #     #       # #   # #   #     #     # #   #   #   #   #     # #   # #     #
### # ##### ######### ######### # ### # ### # ### # # ##### ### ### # # ### ### ##### # ### # # # # #
#   #   #     #   #     #       # #         #   #   # # #       # # # #   #         # #   # # # # # #
####### ####### ####### ##### ######### # ### ### ##### # # # ### # ##### # # ### # ##### # # ### # #
#       #       # # #   #   # # #       # #       #       # #         #   # # #   #     #   # # # # #
# ######### ### # # ### # ### # # # # # ####### ##### ### ########### # ### # ### # ##### ### # # # #
#     #   #   # #       #     #   # # # #   #       # #   # # #       #     #   # # # #           # #
# ####### ### # ### ### ############# ##### # ### # ####### # ######### ##### ####### # # ### #######
# #     #   # #     # #   # #               # # # # #         #         #           #   #   #       #
### ### # # ### ##### # ### # ##### # # # # ### # # ####### # ##### ############# ##### # ###########
#   # # # #     #   #   # #   #     # # # # #     # #   #   #   #   #         #       # #   #   #   #
### # ### ######### # # # ######### # # ##### ####### # ### ######### ### ########### # ### # ##### #
#     #   # #       # # # #     # # # # # # # #     # #   #   #   # #   #   #     #   # #     #     #
# ### # ### ### ####### # ### ### # # # # # ### ### ### ##### ### # # ########### # ### ####### ### #
# # # # #   #       #     #         # #   #     # #       #     #   #     #     #   #       # #   # #
# # # ### ### ### ### ##### ####### ####### # # # # ##### # ### # ##### ### ######### # # ### # ### #
# # # #   # # #     #   #       #     # # # # # # # #         #   #   #   #     #     # #     #   # #
# # # # # # # ########### ### ####### # # # ### # # ##### # ##### # ##### ### ### ### ####### # # ###
#   #   #             # #   # #               # #   #   # # #   #     #     #     #     # # # # #   #
######### # ########### # ########### ### ############# ### # ##### ### ######### # ##### # ####### #
#   #   # #     #     # # #       #   #     #       #     #   # #       #   #     # #               #
# ### ### ####### ##### # ##### ### ############# # # # ##### # ### ### # ########### ##### ### #####
#       #               # # # # #   #     # #     #   #   #     #   #     #   #           #   # #   #
### ### ### # ######### ### # # ### ##### # # ##### # # ### ### ####### # # # ### ##### # ####### # #
# #   # #   #   # #   # # #   #           # #   # # # # # #   # #     # # # #   #   #   #         # #
# ### ######### # ### # # # ##### # # # # # ##### ### ### ######### # ### ##### ### ##### ### ### ###
#   #           #   # # # #     # # # # #   # #       # #   #     # # # #   #           #   # # #   #
# # ### ####### ### # # # ##### ### # ### # # # # ##### ### # ####### # ##### ##### ##### ##### #####
# #   # #     # # #   #   # #       # #   #     #           #   #     #       #   #     #     # #   #
##### # ### ### # ### ##### # ######### ##### ### ######### ### # ### ##### ##### ##### ### # # ### #
#     #       # #           #     #         # # #     # #   #       #     # #     #   # #   #       #
# ### ####### ##### ######### ### ##### # ##### ##### # # ########### ### # ### ##### ####### # # ###
#   # #     #     #           #     #   #     #         #         # #   #   #       #     # # # #   #
# # # ### # ### ####### ##### ####### ##### ####### # ############# ####### # # ##### # # # ##### ###
# # #   # #       # #   # # #     #   # #     #   # # #     #         #     # #       # # # # #   # #
####### # ##### ### # ### # ### ### ### ### # # # ##### ### ####### # ### ##### ##### ### # # ##### #
#   #   #   #   # #   #       # # #     #   # # #       #     # #   # #       # #   #   #   #       #
# ##### # ##### # ########### # # ### ####### # ############# # # # ##### ######### ### # ##### #####
#     #     #   # # #             # # #   #       #     # #   # # #                     #   #     # #
# ### ### # # ### # # # # # ### ### ### # # ##### # # ### # # # ### # ############# ##### # # # ### #
# #   # # # # #       # # #   #   #   # # # # # # # #     # # #     #     #     #   #     #   # #   #
# ##### # ### # ### ######### # # ### # ### # # ##### ### # # # # ############# # # ### ### ##### # #
# #     #   #     # # #       # # #     #   # #   # #   # # # # #   #         # # # #   #   #   # # #
# # # ### ##### ### # ### ########### ### ### # ### ##### ### ### ### ##### # # ### # ##### # ##### #
#   #     # #     #     #       #     # #     #       #   # # #     # #     # #     # #   # #   #   #
######### # ########### # ### # # ### # # ### ####### # ### # ##### # # ##### # ##### ### # ### ### #
#   # # #         #     #   # #   # #   # #     #   #   #       #   # #   #   #     # #   # #       #
# # # # # ####### ##### # # ##### # ### ### # ### # ### # ### # ### # # ### # ####### ### ### ### ###
# #         #     # # # # #     #     # #   #   # #   #     # #     # # #   #     #   #     # #   # #
# # # # ####### ### # ##### # ### ##### # ######### ### ### # ### ####### ### ### ##### # ##### ### #
# # # # #     #   #   #     # #   #     # #   #   #   # # # # #       #   #     # # #   #   # # #   #
# # ### # ### ##### ####### ##### ####### ### # ##### ### ### # # # # # ### # # # # ####### # # # ###
# # #   #   # #           # #   # # #   # # #           #   # # # # #   #   # # # #     # # #       #
# # # ### ##### ### ### # ##### # # ### # # ##### ####### # # ### # ########### # ##### # # ### ### #
# # #     #   #   # # # #         # #   # #     #   #     # # #   #     #       #           #   #   #
# ######### ### ##### # ### # ### # # ####### # # ##### ### # ### ### # ##### # # ### # ######### # #
# # #         #     #     # #   #   #   #     #   #     # #   #     # # # #   # # #   #   #       # #
### # ############### # ##### # ### # # # # ### ######### # ### ####### # # ### ######### # ##### # #
# # # # # # #         #     # # #   # # # # #       #   #   #   #   # #   # # #   # #   #   # #   # #
# # # # # # # # ####### # ######### ### # # # # ### # ### ##### # ### # ### # ### # # ####### ##### #
# #   # #     # # #   # # # #           # # # # #   #   # #   #   # # #   # #   # #   #       # #   #
# # # # ### # # # ### # # # ### ### ### ####### # ### ### ### # ### # ####### ### ### ##### ### ### #
# # #     # # #   #     #   #     # #       # # #   #   # #   #   #     #   # #       # # # #       #
# # ##### # ### ### # ####### ### # ### ##### # ##### # # # ### ####### # # # # ####### # # ### #####
#   #         #   # # #       #   #   #               # # #             # #           #             #
#####################################################################################################
