#####################################################################################################
#       # # #       #   # # #     #                 #       #                 #         #       #   #
# ##### # # # ####### ### # ### # # # # # # # ##### ### # ### ################# ### # ### # # # # # #
# # #   #   #               #   #   # # # # # #   # #   #           # #     # # #   # #   # # #   # #
# # ##### ##### ##### ### # # # ##### ######### # ########### ##### # # ### # ##### # ##### ####### #
#       #       #   #   # #   # #   #     # #   # # #     #   # #       #   #   #   # #         # # #
# # ### # # ####### # # ### ####### ### ### # ### # # ##### # # # # # ### ##### # # # ### ### ### # #
# #   # # #     #     # #   # #       #     # #       #     # # # # # # #         # #     #       # #
# ### ### # # ### ####### ### ####### ### # # ### # # # ####### ####### ####### ######### ### # # ###
#   #     # #   # #   #       # # #       #     # # #   #       #       #   #       # #     # # #   #
### ### ############# # # ### # # # ####### ### ##### ### ### ######### ### # ##### # ##### ##### ###
# # #     #   # #     # # #   # #     #   # #     # # #   #     #   #           #   # # # #   #     #
# # ##### # # # ### ### ### # # ##### # # ##### ### ##### ### # # ################# # # # ### # # # #
#   # #   # #         # #   #   # #   # # # # # #   #   # # # #     #         #     #   # #   # # # #
# ### # ### ### # # ### ### ##### # ### # # # ##### ### ### ####### # ### # ####### # ### ### # ### #
#   #     # #   # # # #   #     #   #   # #   # #       #     #   # # #   #   #         # #   # #   #
### ##### # ### ##### ### ### # # ### ### # ### # ### # # ### # # # # # # ##### ##### ### # ##### ###
# # #     # # # #   #     #   # #       #       # # # # #   #   # #   # # #   #   # # # # # # #     #
# # ##### # # # # ##### ######################### # # ##### ####### # ##### ### ### ### # ### # # ###
#   # # #   #   #       #   #   #       # #     #   # # #           #     # #           #     # #   #
# ### # ### # ### ### ##### ### ##### ### # # ####### # # # ############# # ######### ####### # ### #
#   #       #   # # # # #   #   #   #     # # #         # # #     #     # # #   # #       # #   # # #
# ##### ####### ### # # # # ### # # ##### ### # ####### # ### ##### # ### # # ### # ##### # # ### ###
# # #     #     # # #     #   #   #               # # #     #     # #     #     #   #   # # # # #   #
### # ##### # ### # ### ##### ### ######### # ### # # ### ### ### # ##### ### ######### # # ### # ###
# #   #     #     # #   #           #       # #     # # #   #   # # #     #         # #     # # #   #
# # ####### ##### # ######### ### ##### ####### ##### # ### ##### # ### ### # ##### # ####### # ### #
#   #   # #   #       #         #     #   #         #   # # #       # # #   #   #   #   # # #     # #
# # ### # ### ### ####### ### # ##### # ##### ######### # # # ##### # # # ##### # ### ### # ### # # #
# #   #     # # # #   #     # # # #   #     #   #     #     # # #   # # #   # # # #   #     #   #   #
##### ### # ### # # ### # ### ### ##### ########### ##### ##### ### # ##### # # ##### # ### ##### # #
#   # # # #       #     # #   #   # #   # #     #   # #     #   #   #   #     #   # #   #     # # # #
# ### # ### ############# # # # ### # # # ### # # ### # ##### # # ### # # ### ### # # ##### ### ### #
#   #     # #   #     # # # #   #   # # #     # # #       # # # #     # #   # # #     # # # # # # # #
# ####### ### ### # # # ### # ### # # ######### # # ### # # ### ##### ### ### # ### ### # ### # # # #
#     #       #   # # #     # #   # #             # #   # # # #         # #   # # # #   #           #
# ### ### # ##### ##### ######### # # ##### ### ### ####### # ### ##### ### ### # ##### # ####### # #
# #   # # # #   #           #     # # # #     #   #     #   #         # #   #         # # #       # #
### ### # ### ######### ##### ####### # # ####### ##### ### ############### ####### # # ######### ###
#           #   # #         # # #   # #   #   # #     #       #     #   #     #     #   # # #       #
# ##### ### ### # ##### ##### # # ### ### ### # # ### ####### # ##### ##### ### ####### # # ##### ###
# # #     #   # # #   #   #     #   # #   # # #     # #   #   #         #           # #   #       # #
### # ####### # # ### # # ### ##### ### ### # ##### # # ##### ##### # # ### ####### # ##### ### ### #
#     #     # #   #   # #     #   #     #   #       # #   # #     # # #         # #   #       #     #
# # ####### ##### # ######### ### ####### # # ####### # ### ##### # ######### ### # # ##### ####### #
# #               #       #       #       # # #   #       #   #             #   #   # #       #     #
# ######### # ####### ##### ##### ##### ### # # ########### ####### # # # # ### ##### ### ### # ### #
#     # # # #       #   #   # # # # # # #   # # #   #       #       # # # # # #     # #   #   # # # #
##### # # ####### ### ### # # # # # # ### ### # # # ####### ####### ##### ### ##### ### # ##### # # #
#     #     #   #     # # # #     # #   #       # #     #       #       #       # #   # #   #     # #
# ####### # # ######### ### ### # # # ####### ##### ### # # # ### ######### ### # # # ##### ####### #
#         # # #   # # #     #   # # # # #   #     #   # # # #   #   #     # #     # #       #   #   #
# ##### ### # # # # # ############# # # ### # ####### ### # ####### # ##### ######### ### ##### # # #
# #       #     #       #         #       #   #     #     # #     # #       #     #   #     #     # #
### # # ### # ##### ##### # ##### # # # ### # # ### ### ##### # # # ##### ### ##### ####### #########
# # # # #   #     # # #   #     # # # #   # # #   # # #       # #   # #     #   # #   #     #   #   #
# # ### # # ##### ### # # ### # # ### ##### ####### # ############# # ### # # ### ### ##### ### ### #
#   #   # #   # # # # # #   # # #         #   #   # #         # #   # #   # # # #     # #       #   #
# ### ### ### # # # # # # ##### # ### ####### ### # # ### ##### # ### ### ### # # ### # # ### ### # #
#   # # # #   # #     # #   # # # #                   # # # #         # #   #   # #   #     #     # #
##### # # ### # ### ### ### # ### ### ##### # ####### # ### ##### # ### # # ### ##### ### ##### ### #
#     #   #     #   # # # #   # # # #     # # #     #   #     # # # # #   # #   # #   #   #     #   #
##### ##### # # ##### ### # # # # # # ####### ### ####### # ### ### # # ##### # # # # ##### ####### #
# #     #   # # #           # #   #   #     #     # #     #     #     #   #   #   # # #     # #     #
# # ### ### ### ### ######### # ##### # ### ##### # # # ### # ############# ##### ##### ### # ##### #
# # #   #     # #   # #       #   # #     # #     #   # #   # #     #   #   #         #   # # # #   #
# # # # ##### # # ### ### ######### # ### # ### # # ##### ##### # ### # ### # ####### # ##### # ### #
#   # #     # # #     #   #     #     #   # # # #       #   #   # # # #   # # #   #         #       #
########### ####### ##### # # ####### # ### # ### # # ##### # # ### ##### ### # # ######### ####### #
#   # #     # #   #   #   # #   #   # #   #   # # # # #     # # # # #   #     # #   #       # #   # #
# # # # ### # ### # ### ##### # # ### ####### # # ####### # ### # # # ### ##### ####### ##### # # # #
# #     # #     # #   # #     # #       #     # #   #   # # # # #   #   # #           # #     # # # #
# ##### # ### ### # ### ### ### # # # # ####### # # ### ##### # ### ### # # # ######### ### ### ### #
#   # #   # #   #   # #     #   # # # #         # #     # #           #   # #           #     # #   #
##### # # # ### # ### ######### ########### ##### # # # # ##### ### ### # ############### ### # # ###
#       # # #   #   # # # #         #   # # #   # # # #     #   # # #   #   #       #   # # #       #
# ### ##### ### # ### # # ### # # ### ### # ### # ##### # # # # # # ############# # # # # # ### ### #
#   # # #     # #     # #     # #   #   #     #   #   # # #   #   # #       # # # # # # # #     #   #
# # ### ### # # ####### # ####### ##### # ### ####### # # ### ### ##### ### # # # # ### ### # ### ###
# # #   #   #   #   #   # # #   # # #   #   # #         # #     # # #   #     #   # #       #   # # #
### ### # ####### ### ##### # ##### ### ### ##### ### ##### # ### # # ######### # ####### # ### ### #
#   # # # #     #         #       #   # #       #   # # # # #   #     #   # #   #   #     # # #     #
### # # ##### # # ####### ### ### # # # ############### # # # # ##### # ### ##### ### # # ### ### ###
# #   # #     #   #     # #     # # #       # # #     # #   # #   #   # #         #   # # #   # #   #
# # # # # ####### ##### ##### ####### # ##### # # # # # # ####### ##### # ######### ### # ### # # ###
# # # #   #     #   #     # #     #   # #   # # # # #       #   #             #     # # # #   #     #
# # # # ### # ### # ### # # ### ### ### # ### # # ######### ### ####### ##### ##### # ### # # ##### #
#   #   #   # #   # # # # #       #   #         #     #   # # # #   # #   # #   #     # # # # #     #
# ##### # ### ### ### # ### ##### ####### ### # # ##### ### # # # ### ##### ### # ##### # # # # #####
#     # #   #     #   #     # #       # # #   #     #   #       #     #     # # #   # #     # #   # #
# ### # ######### # ######### # ### ### ### ##### # ### # ### # # ##### # # # # ### # ### ####### # #
# # # #     #       # #   #   # #     #   # #     #   #   #   #       # # # #   # #     # #     #   #
# # # # ############# # # # ### ####### ############### ####### # # ##### ### ### ####### ### ### ###
# #   #           #   # #   # # #     #           # #   #       # #       #     #   # #     # #   # #
# ####### ####### # # # ##### # # ### # ########### # ### ########### ####### # # # # ####### # ### #
# # # # #   # #     #     # #     # # #               # #     #   #       # # # # #     #     # #   #
# # # # ### # ### ### ##### # ##### ##### ##### ### # # # ##### ### # ##### ##### ####### ##### # ###
#     # #   #   #   #     # # #   #     #     # #   #   # # # # #   #     #     #     #         #   #
# ##### # ### # ##### ### # # # ### ### ####### # ####### # # # # # ##### ### # ### ### ### # # # # #
# #           #     #   #   #       #           #   #         #   # #         #   #     #   # #   # #
#####################################################################################################
