#####################################################################################################
#     # #     #   #       #           #         #   #             #     # #       # #   #   #   #   #
##### # ### ### ### # ##### ####### # ### # ### ### # ##### ##### # ### # # ####### # ### ##### # ###
#   # # # #       # #       # #     # #   #   #     #   # # #     # #         #         #   #       #
# ### # # ### # # # # ##### # # ##### # ####### ##### ### ### # ##### ####### ####### ##### ##### # #
#   # #     # # #   #     # #   #   #       #   # # #   #   # #   #     #           #           # # #
# ### ### ### ##### ####### ### # ### ### ####### # ### ### ##### # ### ######### # # ### # ### ### #
#               # # #   # #   # #   # # # # #   # # #         #   # #         #   #   #   #   # #   #
# ### # # ### # # ### ### # # ##### # # # # ### # # # # ### # # ######### ##################### # # #
#   # # # # # # # #     #   # # #   # # #       # # # # #   # # #   #     #     #       #     #   # #
# ### ##### # ### # ##### ### # # ### # ### ### # # # # ######### # # # # ##### # # ### # ### ### ###
# #         # #     # #   #   #       # # #   # #     #   # #   # #   # # #     # # #     #   #   # #
# ### ### ### # ### # ##### ### # ##### # # ##### ### ### # ### # ##### # # # ### ##### ########### #
# #   #   # # #   #           # #   #       # #   # #   #       # # # # #   #     #   # #   # # #   #
### ##### # # ############################### ##### # # ### ### ### # ### # # ### ### ##### # # ### #
#       #   # #         #   # #   # #   #       #   # # #   #   # # #     # #   #     #     #       #
# ##### ### # ####### ### ### ### # # ######### # # ### # # ### # # # ### ######### ### # # ##### # #
# #   # # # #   #           #   #   #     #       #     # #   # #   #   #   #     #   # # #       # #
# ### ### # ### ########### # ##### ##### # ##### ##### ####### # ### ########### ####### ### # #####
#   #       #           #             #     #         #   #   #     #               #   # #   #     #
##### ### ####### ### ### ### ### ### ### ##### # ####### # # ##### ##### ##### # # ### ### ####### #
# # #   #     # #   #   #   # #     # #   # # # #   #       #     #   #     #   # #         #   #   #
# # ### # ### # ####### ##### # # # ### ### # ############# ######### # # ############### ### #######
# # #   # # #     # # #     # # # # #   # #   #     # #       # #       #   #   #   # #       # #   #
# # # ### # ##### # # # ### ### ##### ### ### # ##### ##### ### ##### ##### # ##### # # # ### # # # #
#       # #   #     # #   #       #       #       #       #   #       # #   # #   # # # # # #   # # #
# # # ### # ### ##### # # ####### # # ##### ####### # ############# # # ### # # # # # # ### ####### #
# # #   # #     # # #   #       # # #     # # #   # #   # #       # # #       # # #     #   # #   # #
# # ### ######### # # # # # # ### # # # ### # # # ##### # # ################# ### ######### # ### # #
# #   #     #   #     # # # # #     # # #       # #   #   #   #     #       #     # #   # # #     # #
# # ### ### # ######### ### ##### ##### ####### ##### ### ### # # ##### # # ##### # # ### # # ##### #
# # #   #     #     #     #   #   # #         #     #           # #     # # #     #     #     # #   #
### # ####### ### ##### ##### ##### # # ### ##### # # ########### # ####### ##### # ##### ### # # ###
# # #   # #       # #   # #   #     # # #         #   # #   # #       # # #     #   # #     # # #   #
# ### # # # ##### # # ### # ### ####### ##### ### ##### ### # ### ##### # ### ##### # # # ### # # ###
# #   # #   #     #       #           # # # # #     #           # # #       # # #   #   # #   #     #
# # ##### # # ######### # ######### # ### # ##### # ########### ### ####### # # ############# # # # #
#   #     # #     #   # # # # # #   # # # #   #   #           #   # #       #   # #             # # #
# # ############# ### # # # # # # ### # # # ### ####### # ### # ### # ### # ##### # ### ####### ### #
# #   # #         # #   # #         #   #       # #   # #   #   #   # #   #   # #     # #   # #   # #
# ##### ### # # ### # # ### # ### ### ##### ### # # ### ### ### ### # ######### ### ### # # # ##### #
#     #     # #     # #   # # #   # # #       #   #   #   #   #   # # #         # # # # # #     # # #
### ######### ### ### ### ######### # ####### ##### ##### ##### ### # # # # # ### # # # # ### # # ###
#   #     # # #     # #   #   #         #       #       #     #   #     # # #     # #     #   #     #
# # ##### # # ##### ##### # ### # # ### ##### ##### ##### # ##### ### # ########### # ############# #
# # #     # # #   # #     # #   # # # # # # #   # # #   # # # # #   # # #       #   #       #       #
# ### ### # # ### ##### # # # ##### # # # # ##### # # # ### # # ##### # ##### ##### # ### # #########
#   #   #   #   # #   # # #     # #   #         #     #   #     # # # #             #   # #   #   # #
### # # # ####### # ############# ######### # # ######### ### ### # # ####### ### ##### # ##### # # #
# # # # # #     #   # # #         # # #     # # # #                   # #     #     #   # #     # # #
# # # ##### # # # ### # # # ####### # ##### ##### ### ####### ##### ### ### ##### ##### ### ####### #
# #       # # #     #   # #       #         # # # #       # # # #     #     # # #     # # #         #
# ### ### # # ##### # ####### # ##### ####### # # ####### # # # ### ######### # ### ### # ### ### ###
#       #   # #   # #       # #               #   #   #     # #   # #   #     # # #   # #     #   # #
### ######### # # # ### ### ### ### # ##### # # ### ### ### ### ##### ### # ### # # # ##### ##### # #
#       # #     # # #     #   # # # # #     #   #       #         #     # # #   # # #         # # # #
# ##### # ### ##### # # # ####### # ####### ############# # # # # # # # # ### # # # ####### ### ### #
# #         #   #   # # # #   #     # # # # #   #         # # # # # # #   # # #   #       #         #
# ####### ##### # ####### ### # ### # # # ### ### ##### ######### # ####### # ### ### # #############
#     #   #   # # # #           #   #   # #     #     #       #           #   # # # # # #   # # #   #
##### # ### # ### # # ### ### ### ### ### # # # # # ##### ##### ##### ### ##### # # ##### ### # # # #
#   # #   # # #     #   #   # #           # # # # # # #     #       # # # #           # # #     # # #
# ### # ##### ##### ####### ##### ### # ### ### # ### # ######### # ### # # ##### ##### # ### ### # #
#     # #   #   #   # # # #   #   # # # #     # # #       # #   # #   #     # #               #   # #
# ######### ### # # # # # # ##### # ### # ### # # ##### # # # # # ####### ### # ##### ####### # ### #
#     #   # # #   #   # #     #   # #   #   # #     #   #   # #       #   #         # # # #   # # # #
# ##### # # # # ##### # # # ### ### ### ### ####### # ####### # # ### # ##### ### ### # # # # ### # #
# #   # # # #       # #   # # #     #   #       #   #   #     # # #   #   # #   #   # #     #       #
# ### # ### ############# ### ### ######### ### # # ### ########### ### ### ####### ############# ###
#   #         #       #       # #   # #   #   # # #   #   #   #     #   # #   # # #             #   #
### ##### ######### # ### # # # # ### # ##### ### ### # ### ######### ### # # # # ### ##### # #######
#   #       # #     # #   # # #       #   #   # #   # # #   #     #       # #         #   # # # #   #
# ### # # ### # ##### ### # # ### # ### ####### # ##### # ### ######### ##### ########### # ### # ###
#   # # #   #   #   #   # # #   # #   #               #   # # # # #       # # #     #   #   #   # # #
### # ########### # ### ####### # ######### # ### ######### # # # # ####### # ### ### ####### ### # #
#               # #           # # # #     # #   #   # #       # #   #     # # #       #     # #     #
############# # # ##### ####### ### ##### # # ##### # ### # ### ### # ##### # # ########### # ##### #
# #       #   # # # # #       #         # # #   #       # # # #         #         #   #     #       #
# # # ##### ### ### # ##### ### ### ##### # ##### # # # ### # # # ### ### ########### # ##### # ### #
# # # # #     #     #   # #       # # #   #   #   # # # # #     #   # # #     #       #   #   #   # #
# # # # ### # ##### ### # # ### ### # # ### ### ### ### # ######### # # ### # # ### # ### # ### #####
#   # # #   # # #       #     # #     #   # #   #     #     # #     #     # #     # # #       # #   #
### ### # ##### ### ####### ##### ####### # # # ### ### ##### # ############# # # ### # # ### ##### #
# # #         # #     # # # # #   #         # #   # #   #   # #   #         # # # #     # #         #
# # ### # ### # # ##### # ### # ### ########### # # # ### ### # # ####### ####### ### ##### ##### # #
#     # #   # #       # # #     #           # # # # #         # # # #           # #     #     # # # #
# ### ######### # ##### # # ##### ####### # # # ### # ##### # ##### # ######### # # # ######### # # #
# # # #   #   # #   #   #   #   # #     # # # #   # # #     # # #     #     # # # # #   #     #   # #
### # ### # ####### # ### # # ####### ##### # ### ### # ### ### ### # # ### # # ### ### # ######### #
# #     #       # #   #   #   #   #     #   #     #   #   #   #     #   # # #     # # #   #   #   # #
# # # ### # # ### ##### ####### # # ### # ### ##### # # # # ##### # ##### ### # # # # # ### # # ### #
# # #     # #             # # # #     #     # # # # # # # #       #   #     # # # # # #   # #   #   #
# # # ### ##### # ### # ### # ####### ### ##### # ### ##### ####### # ### # ##### ### # # ### # ### #
# # # #     #   # #   # #   #   #       # #   #   # #   #       #   #   # # #   # #     #   # #     #
# ### ### # ####### ### # # # # ##### # ##### # ### ### ### ##### # ####### # # ### ####### ##### # #
#     # # #   #     #   # # # #       #       #   #     #     # # # #     #   # #   # #     #     # #
####### ################### # ##### ### # ##### ##### # # ##### ### # ### # # # # # # ##### # ##### #
#   #             #   #       # #   #   #   # #     # # # # # # # # # # # # # # # #   #   # #     # #
# ### # # ##### # # # # ##### # # ######### # # # # # ##### # # # # # # # ### # # ##### ### ####### #
#     # #     # #   #   #       #         #     # # #             #     #     # #     #       #     #
#####################################################################################################
