###################################################
#   #             # # #         #         #       #
### # ##### # # # # # # ####### ####### # ### #####
#     # #   # # # #   #     # # #   # # #     #   #
# ##### # ##### # ### ### # # ##### # # ### # # # #
# # # #     # # #         #   #     # # #   #   # #
# # # # # ### ### ### ##### ### # ### # ### ### # #
# # #   # # #     #   #     #   # # #   #   #   # #
# # ### # # # ##### ########### ### # ##### # # ###
#   #   #   #   # # #     #   #   #     #   # #   #
############# ### # ### # # # # # ### # # # ##### #
#     # #     #   #     #   # # # # # # # #     # #
# ### # # ### ### ### ### ### # ### # ### ### ### #
# #         # #   # # # #   #     #     # #   # # #
# ##### # ### # ### ### # ########### # # # ### # #
#     # # # #   #               #   # # # # # # # #
# # ### # # ### # # ##### ##### # # # ### ### # # #
# # # # #   #   # #     #   #   # #   # # #   #   #
### # ##### # # # # ####### ### ####### # # # #####
# #   # # # # # # # # # #     # #         # #   # #
# # # # # ### ##### # # ### # ####### ##### # ### #
#   #     # #     #   # #   #     #         #     #
### ####### ##### ### # # # ### ##### ##### #######
# # # #             # #   # # #   #     # # #   # #
# # # # ####### ### ### ### # ### # ##### ### ### #
# #   # #       #   #     # # # # #   #   #   #   #
# # ### ##### # # # ### # ### # # # ### # ### ### #
#   #     #   # # #   # #   #         # # # #     #
############# ##### # ########### # # # # # ##### #
# #   #         # # # #   # # #   # #   # #       #
# # # ####### ### ### ### # # ### ##### # ####### #
#   # #   #         #       #     #     #   # #   #
### ### ##### # # ######### ### ####### # # # # # #
#   # #       # #     # #   #   # # # # # #     # #
# # # ########### ##### # # # # # # # ####### # ###
# # #   #         # #     # # #       #       # # #
### ### # ####### # ### ##### ##### ####### ### # #
#             # # # # #   #       #   #   # #     #
# ### # ####### ### # ########### ### # ###########
#   # # # # #     # #   #         #       # #     #
####### # # # # ### ### ### ##### ##### # # # ### #
#       #     # #   #         #   # #   #     #   #
### ##### ##### # ####### ##### # # # ##### ##### #
#     # #   #   #           #   #   # #   # #     #
# # ### # # # ######### # ######### # ### # ##### #
# #     # # #     #   # # # # #     #   #   # # # #
# ### ######### ##### ##### # ####### ### # # # # #
# # # #   #   #     #     #   # #       # #   #   #
# # # ### # ##### ### # ##### # # ### # # ### #####
#   #     #           #             # # # #       #
###################################################
