###########
#     #   #
### # ### #
# # # #   #
# # # # ###
#   # #   #
# ####### #
#     # # #
# ### # # #
#   #     #
###########
