#####################
#   #       # #     #
# # ##### ### # # # #
# #         # # # # #
######### # # # ### #
# #   # # #   # #   #
# # # # # # ####### #
#   # # # # # #     #
# ##### # # # # ### #
#         #       # #
### ####### # ##### #
# #       # #   #   #
# ####### ##### #####
# # # # # #         #
# # # # # # ####### #
# #   #   #   #   # #
# # ######### # ### #
#         # # # # # #
# # ##### # # # # # #
# #   #         #   #
#####################
