###################################################
#           # #     #   #         #               #
########### # ### # ### # ##### ### ##### ### ### #
# # # #         # #       #     # #   # # # # # # #
# # # # ##### ### ####### # # # # # ### ### ### ###
# #   # # #           # # # # # #         #       #
# # # # # ####### ### # ##### # # ### ### # # #####
# # # # #     #   #     #     # # # # # #   # #   #
# # # ####### # # ### ### ##### ### # # # ### ### #
# # # #   #     #   # #   #   # #     # # #   #   #
# # # ### ### ##### # # ### # # # ### # ### # ### #
#   # #       #     # #   # # #   #   #     # #   #
### ### ### ### ### # ####### ### ######### # # # #
# #       #   # # # #   # #     #   #   # # # # # #
# # ### ##### ### ##### # # ####### ### # # # # ###
# # #     # # # #   # #     #     # #       #     #
# ######### # # # # # ### ### ### ####### # ##### #
#   #         #   #     # # # # #         #   #   #
# # ### # ### # # ######### # # ### ####### # #####
# # #   #   # # #   #     #     # #     #   #     #
### # ##### # # # # # ### # ### # ####### ####### #
#     #   # #   # #   #   # #   # # #       # # # #
# ### ### ### # # # ######### ### # ### # ### # # #
#   #     #   # # #       #   # # #   # # #     # #
# ##### ##### ##### # ##### ### # ### ### ### ### #
# # #     # # #   # #     #     #     #     #     #
# # ####### # ### ####### ##### ##### # ### # ### #
#   # #   # # #       #   #         #   # # # # # #
# ### # # # # # ### # ### ########### # # # ### # #
#   #   # # #   #   #   #   # #     # # # # #     #
# ##### # # ##### ####### ### ##### ### # ### #####
#     # #   # # # #     # #         # #   # # #   #
####### ### # # # # # ### # ### ##### ### # ##### #
#     # # #       # #     #   #       # # #   #   #
# # # # # ### ##### ####### # # ### ### # # # ### #
# # # #     #     # #   #   # #   # # #     #     #
# # ### # ### ### ### # # ### ##### # # ##### #####
# #     #   #   #     #   #   #   # #   #   # #   #
# ####### ####### ####### ### ### ##### # # ### # #
#   # #     #   # #     # #   # #     #   #     # #
# ### ### ### # ### ##### ##### ### ##### ####### #
#       # #   #       #   #           #       #   #
##### ##### # ####### # ####### # ##### # ### ### #
# #         #   #   # #   #   # #       # #     # #
# # # ##### # # # # ##### # ######### # ### ### ###
#   # # #   # # # #   #     #   # #   # #   #   # #
# ### # ######### ########### ### # ####### ##### #
#   # #   #   #             #   # # # #   # # #   #
# ####### ### ### ######### # ### # # # # # # # # #
#         #         #                 # #       # #
###################################################
