###################################################
#   # #                   #     # #     #     #   #
# # # # # ### ##### ### # ### # # ##### # # # # # #
# #     # # # #     #   #     #   # #     # #   # #
# ### ### # ### ######### ####### # ### ####### # #
# #   #   #   #       # #   # #           #     # #
# ########### ### ##### ##### ### ### ########### #
# #     #     #     #         #   # #         #   #
# ### ### # ####### # # # ### ### # ####### ### ###
#         # #       # # #   #     #           #   #
### ### # ### ##### # ######### ######### #########
# # # # #   #   # # #       # #     # #     #   # #
# # # # ### ##### ### # ##### ### ### # ### # # # #
# # # #   # #   #     # #       # #   # # # # # # #
# # # ### ##### ##### ### ##### ##### # # # ### # #
#   # #         #   # # #     #   #   # #       # #
# ### # ####### ### # # ##### ####### ##### # ### #
# #   #   #     #   #         #       # # # # #   #
# ### # # ##### ### ### ####### ##### # # ####### #
#     # #     # #   #     #       #   #     #     #
### ### # ##### # # ############### # ### # # ### #
# # # # #   #     # # #     #     # # #   #   # # #
# ### # # ##### ##### # # ####### # ### ### ### # #
# #     #     # #     # #   #           #   #     #
# # ### ##### # # ##### ### # ##### ### ### ##### #
#   # # #   # #       #   # # #   # #     # #   # #
##### ### ### ### # # # # # # # ########### ### # #
# #     # #     # # #   # # #       #   #   #     #
# # ### # ### # ### ####### # ##### # ######### # #
#   #   #     # #   #   # #   #   #   #       # # #
# ### # ########### ### # ### ### # ##### ### # ###
#   # #             #     # #     # # #     #   # #
# # ############# ### # # # ######### ########### #
# #       #     #     # # #     #           #     #
# ####### ### # ##### ####### # ##### ####### #####
#       # # # #   #     # #   # #   # # #         #
### ### ### # ### # # # # # ### ### # # ### ### ###
# #   # #     #     # #     #       #     #   #   #
# # ##### # ####### ##### ### ######### ##### #####
# # #     #   #   # #   #   # #           #   #   #
# ### # # ### # ### ### # # ### ### # ##### ### # #
# # # # # #   #       #   # #   #   # #     #   # #
# # # ####### ##### # ### ##### # ### # ### ##### #
#     #     # # #   # #     #   # #   # #   # #   #
# ######### ### # ### ##### # ##### ### # ### # # #
# #       # #   #   #     # #   # #     #   #   # #
# ### ##### ### ##### # # ##### # # ############# #
#   # #       #   #   # #     #   #         #   # #
# ### ### ### # # # ######### ######### # # # # # #
#           #   # #       #             # #   #   #
###################################################
