#####################################################################################################
# #   #         #     #   #   #       #       # #     #   #                 #             #   #     #
# # ### ### ### # # ### # ### # ### # # # # # # # # # # ### # # # ### # # ### ### ### ####### # #####
# # #     #   #   #   # #   # # #   #   # # #   # # #     # # # #   # # # # #   # #   #   # #       #
# # ### ######### ### ### ### ##### ########### ##### # # ######### # ##### # # ### # # # # ### ### #
#       # #       #     #     # #         # #   #   # # # #   # #   #   # #   #   # # # #   #     # #
# ####### # ######### # ### # # ### ####### ####### # ##### ### ### ##### ### ### ####### ### ### # #
#   #   #       #     #     # # #     #   #   # #   #   # #     #   #   #     #   #       #   #   # #
### # # # # # ##### ### ### ### # ##### # ### # # # ### # # ### # ### # ### ##### # ### ### ### #####
#   # # # # #     # #   #   #   # #     # # #     # #     # #         #   # #     #   # #     #   # #
# # ### ### ####### # ##### ### # # ####### ### ####### # # ######### # # # ### ### ### # ######### #
# # #     #     # # # #     # # # # #   #   # # #       # #       #   # # # # # # #   #   #     #   #
### # ######### # ### ####### # # # ### # # # # ### ### # ######### # ##### # ### # # ##### # ### # #
#   #   #     # #       #     #   #       #   #       # #   #   #   #   #   # #     #       # # # # #
### # ##### ### ####### # ##### ### ####### ### # ##### ##### ### # # ##### # # # # ##### ### # # ###
#     #   #       #     #           #   #     # # #   #           # #   #   # # # # # #   #   #     #
# ### ### ##### ##### ##### ### ### ### ##### ### # ### ### ### ### ##### # # # # ### # # ##### # # #
#   # # #   # #   #     #   #     #         #   #   #     # #   # # # # # #   # # #     # #     # # #
# # ### ### # ######### ######### ### ####### ##### ##### # # ### # # # ##### ##### ##### ##### ### #
# # #   #   #     # # #   #       #   #           # #     # #     #   # #         #     # # #   # # #
# ##### # ### ### # # ### ### # # ##### ####### ### ### ### ### ####### # # ##### # # # # # ##### # #
#         # #   # #     #     # #     #       #     #     # #   #     # # #   # #   # # # #   #     #
# # ##### # ### ##### # ### # ############# # ####### ######### ##### # # ### # # ##### ### ### ### #
# # # #       #   #   # #   # # #   # #     #   #   #       #   # #   # #   #   # #           # #   #
# ### # ####### # # # # ##### # # # # ##### ### ### ### ### ##### ### # ####### ### ######### # #####
# #   # #       # # # #   #   # # # #   #   #     # # #   #   #   #   #     # #   #     # # #   #   #
##### # ### ########### ####### # # # # ##### ##### # # ### ### ### # ##### # # ### # # # # ### ### #
# # #   #       #   # # #   # #   #   #     #     #     #   #       #   #   #   #   # #     # #     #
# # ### # # ##### # # # # # # ### # ####### ##### ####### ##### ##### ### # ##### ########### # # # #
# # # #   #     # #       # #   # # #   # # #   #   #   #   #     #   # # #       #     # #     # # #
# # # ##### ### # # # ######### # # # # # ##### ### # # # ### # ##### # # # ####### ### # ### ### # #
#     # #   #     # # #   #   #   #   #   #     # #   # # #   # #   #   # # #   #   # # # #     # # #
# ##### # ######### # # ##### # ### # ######### # # # ##### ##### ### ### # # ### ### # # ##### #####
#         #   # #   #       #   #   # # # # #     # # #         #   # #   # # #   # #       # # # # #
# ##### ##### # ### ####### ####### ### # # # # ### # # ##### ### ### # # ### # ### ##### # # ### # #
# #   #       # #     # #       #   #       # # #   #     # # #     # # # #   # #     #   # # #     #
# ### # ##### # ### # # ### ##### ####### ##### # ##### # # # # ##### # ##### # ##### ### ### ### ###
# #   #   # # # # # #   #     #   #       #   # #   # # #   # #       #     # #   # #   # #       # #
# ### ### # ### # # ######### # ### ### # # ### # ### # ########### ### # ### # # # ### # # # ##### #
#     # # #     #   #   #     #   # # # # #       #       #         #   #       #     #     # # #   #
##### # # # # # ### # ### ####### # # # ############# ### # ####### # ##### # # # # ##### ##### # # #
#   # #     # #   # #     #   # # # #     #   #       #   #       #       # # # # # #   #       # # #
# ####### ####### ### # ### ### # ##### # # ##### # # ############# # ### # ##### ### ####### ##### #
#       # #   # # # # #   #     #       #     # # # #     #   #   # # # # #     # #   #     #   #   #
# ##### ##### # # # # ##### ### ############# # ### # # ### ### ### # # # # ### ### # # # ##### # # #
# # # #     #   #   # #       # #         #     #   # #   #     #   # #   #   #   # #   #     #   # #
# # # ##### # # # ##### ### ##### ### ##### # ### ######### ##### # ### # ####### # ### ##### ##### #
#   #   #     #           #   #   #     # # #             #       # # # # #   # #   #     #   #   # #
# ##### # # # ##### ####### ### ### ##### ####### ### ### ######### # ####### # ### ####### ##### # #
#     # # # # #     #   #   # # #   # #         #   # # #       #   #     #     #   #     # #   # # #
# ### # ##### ####### # ##### ### ### ### # ### ### ### ##### ### # ### ### # ##### # ##### ### # # #
# # #   # #         # #       # # #     # # # # #   # # #       # #   # #   #       #             # #
### ### # ### ### ### ### ##### # ##### # # # # ### # # ############### ### ##### ############# #####
#     #     #   # #     #       # # # #   #   #     #         #     #       # #       #     #   #   #
# ### # # ### # ##### ######### # # # # ####### ########### # ### ### # ##### # ######### # # # # # #
#   #   # #   # #   #   #   #     # #       #       #     # # # #     #   #   # # #   #   # # # # # #
####### # ### # # # # # ### ### ### ####### # ##### # ### # ### # ### # ##### # # # # # ######### ###
#       # #   # # #   # # #       #     #   # # # # # #   #   #   # # # # # #       # #     # #   # #
# ### ######### # # # ### ####### # ####### ### # # # ### ### ##### # # # # ##### ####### # # # # # #
#   # #   #       # # # # #     #   #     # #     #   # #     #     # # #   #   #   #     #   # #   #
# ### ### # ### ##### # # # # ######### ##### ### ### # # ##### ######### ### # ### # ##### ### ### #
# #     #     #   # #   #   #             #     # #     # #   # #   # # #   # #   #   #   # #   #   #
####### # ### ##### # # # ##### ####### ### ##### # ### ### # # ### # # # # ### ##### # # ### # #####
#   #   # #   # # #   # #   #     #   # #   #     # #       # # #   # #   #     #   #   # # # #     #
# ### ### ### # # # ##### ########### # ####### ##### ### ### # ### # ##### ### # # # ##### ### # ###
#     # #   # #   #     #   # #     #     #         #   # # # #     #         #   #     #       #   #
# ##### ### # ### ### ### # # # # ####### # # ##### ### # # # # ### ############################### #
#     #   # # #   # #   # # #   #   # #     #     #   # # # #   #   # #                   # #       #
####### ### # # # # ##### ### ### # # ### # ####### # ### # # ### # # ### # ######### ### # ### ### #
#     # #   #   # #   #         # # # #   # #       #     #     # #     # #     #     #       # # # #
# # ### # ### # ### ### ### ##### # # # ### ### ####### # ### ##### # ######### ####### ### # # # ###
# #       #   # #   #     #   # # # #   # # # #     #   #   # # # # #       # # # #     #   #   #   #
# ################# ### # ##### # # ##### # # ### ### ##### # # # ### ### # # # # ### # ######### # #
# #     # #         # # #   #   # # #       # #   # #   # # # #     # # # #       #   #   # # #   # #
# # ### # ##### # # # # # ##### ### # ####### # ### ##### # ##### ##### # ##### ####### ### # ##### #
# # # #   #   # # # #   # #     # # #   #         # # # #   #     #   #       #     #     # #       #
# # # ##### ####### # ### # ### # # ##### ##### ### # # ##### ### ### ####### ##### # ##### # ##### #
#   #       #       # # # #   #   #   # # #         #   # #   # # #   # #   # #     #     #   #     #
# ##### ### # ####### # # ### ##### ### ### ##### ### ### # ### ### ### # ### # ### ##### ##### ### #
#     # # #           #   #             # #     # #   #   #             #     # #       # # #   #   #
######### # ### ############# ### # # ### # # ### ### # ####### ### # ### # ##### ### ##### # ### ###
#   # #   #   # #   #         #   # # # #   # # # #     #   # #   # # #   # #   # # # #       #   # #
# ### # ########### ################# # # # ### # # ### # ### ### ########### ### # # # ######### # #
#     #       #   # #     # # #       #   #     # # # # #   #         #           #           # # # #
##### # ##### ### # # ##### # # ### ######### ##### # # # # # ########### # ######### # # # # # # # #
#       #   #       #   # # #   #   # #   #     #   # # # #     # # #   # # #     #   # # # # #     #
# ### # # # ########### # # ### ##### ### ##### ### # # ##### # # # # # ####### # ### ###############
# # # #   # #   #     #     # #               #       # #     # #   # #         # #       #       # #
# # ### ##### # # ### # # ### ############### ### # ### # ####### # # ################# ##### ### # #
#   #   # # # #     #   # #       #   #     #   # #   #     # #   # # #       #     # #       #     #
# ####### # ######### ##### ##### # # # ### # ##### # ### ### # # ### # # # ####### # ### ##### ### #
# #       # #         # #   # #     # #   #     # # # #   #   # #       # # #   # #     #     # #   #
# ### # ### # ##### # # # ### # # ##### # # ### # ######### # # ######### ### # # # ### ### # ### # #
#     # #     #   # #   #   #   # #     # # # #   #   #   # #   # #   #       # # # # # #   #   # # #
### ########### ### ########### # # ##### ### ### # # ### # ### # ### ### ####### # # ##### ### #####
#   #   # # # #       # #   # # # # #         # # # #       # #   #     # #   #     #   #   # #     #
### ### # # # ### # # # # ### # ### # ####### # # ### ##### # # ### ######### ### ### ### ### ##### #
#     # #         # #   #   # #     #   #   #   # #   #   # #   #     # # #   #   #   #     #   # # #
# # ### ### # ##### # # ### # # ### # ### ####### # # ### ### ##### # # # ### # ### ### ### ### # # #
# #         #   #   # #           # #           #   #     #         #             #       #     #   #
#####################################################################################################
