###########
#   #     #
# ### ### #
#     # # #
# ##### # #
#   # #   #
### # ### #
#   # # # #
# ### # # #
#   #     #
###########
