#####################################################################################################
#       #                     #       #           # #       # # #       #     #       # #         # #
# ####### ####### # ### ##### ### ##### # ### # # # # # ### # # ### ### ### # # # ##### ### # ### # #
# #   # # #       # #   # #       #   # # #   # # # # # # #   # #   #     # # # # #     # # # # #   #
# # # # # ######### # ### ### # # ### ### # ### ### # ### ##### # ####### # # # # # ### # ### # #####
#   #             # # # #     # #   #     #   # #         #     #   #   # # # # # # #       #       #
# # ### ########### # # ### ### ### ### ### ##### # ######### # ### # # # ### ### # ####### ##### # #
# #   #     #     # # # # # #     #     #     #   #   #     # # #     # #     #   # # # #     # # # #
### ##### ### ### # # # # # ### ######### # # # ########### ### # # ##### ### # # ### # # # # # ### #
# #   #     #   #   # #   #   # #       # # #   #       # #     # #   #     #   #     #   # # #     #
# # ####### ####### ### ### # ### ####### # ##### ### # # # # ########### # # ### # ### ### ####### #
# #     # #     #       #   #   #     #   # # #     # #     # #     #     # # # # #     #   #     # #
# # ##### ##### ### ######### # # ### ### ### ##### # # ########### # ##### ### ### # ### ### ### # #
#       # # # #   # #   #   # #   # # # #   #   # # # # #   #     #   # # #   #   # # #     # #     #
######### # # ### ##### # ### ##### # # ####### # ### # # # # # ####### # # # # # # # ### ### ##### #
#     #   #         #       #   # # #   # #   # #     # # #   #   #     #   # # # # #   #     # #   #
# # ##### ####### # ### # # # # # # ### # # ### # ####### ### ######### ##### # ############### # ###
# #   # #   #     # # # # # # #   #   # #         #   #     # #                     #   # #   #     #
# # ### ### # ####### # # # ####### ##### ### ####### ##### ######### # # # ### ### ### # ### ##### #
# # #     #   #     # # # #   #   # # #     #     # # #           # # # # #   #   #     #   #     # #
### ### # ### ### # # ### ### # ### # ##### # ### # # ### # ### # # ### # ### # # # ### # ####### # #
# #     # #       # #       # #   #     #   # #     # #   #   # # #     # #   # # # #   # #     #   #
# ##### ##### ### # ##### ### ### # ####### # ### ### ##### ##### ####### ### # ######### # # # ### #
#       #   #   # # # # # #     #   #   #   #   # #   #   #   # #     #     # # #   #   #   # # #   #
### # # # ### ### # # # # ####### ### # ##### ### ### ### # ### # # ### # # ####### ### ##### #######
#   # #   # # #   #         #     #   # #   #   #       #     #   # #   # # #           # # #   #   #
##### # ### # ### ##### # # ##### ### ### ######### # ### ### ##### # # ##### # ### # ### # ### ### #
# # # #       #   #     # # #     # #       # #   # #   # # #     #   # #     # #   # #     #     # #
# # # ####### # ##### ##### ### ### # ### ### ### # ### ### # ##### # # # ##### # ####### # ##### # #
# #       #   #     #   #         #   #   # #       # #     # # #   # #   #     # #       #   #   # #
# ### ### ##### # ####### # ######### ### # ##### # # # # # # # ##### # # ######### ##### # # # ### #
# #     #     # # #     # # # #       # #     #   # # # # # #   #     # #     # #   #     # # #     #
# ### # ##### # ### ### # # # ####### # ### ##### # # ### # ##### # ####### ### # ### # ##### # #####
#     # #     # #   # #   #               #   #   #   #   #       #       #       #   #   #   # #   #
### ### # ##### # ### ### # ####### # ####### # ####### # ##### # # ####### ####### ### ####### ### #
# # # # #     # #     # # #       # #   # #     # # # # #     # # # #           #     # # # #   #   #
# ### ####### # ##### # # ######### ##### ### # # # # # ####### ##### # ################# # # ### ###
# #     # #   #     #   # #   #   # #         # #   #   # #   # # #   #         #     # #   # #     #
# # # # # # ######### ##### # ### # ### ##### # # # # ### ### ### # ##### ######### # # # ### # #####
# # # #   #   #   #   #   # #       # #     # #   # #     #     #     #             # #   #     # # #
# ### ### # ### # ##### ### ####### # ### ####### # ####### ### ### ### # ##### # # # ### # ##### # #
#       # #     #   #   #   #   #   # # # # #     #     #     #     # # # # #   # # #     #       # #
# ### # # ### ### ### ### ##### # ### # # # # ##### ### ######### ### ##### # ### ####### # # # ### #
#   # # #     # #     # # # #       #     # #     # #     #     # # #       # # # #         # #   # #
### ### ### ### # ### # ### # # ####### ### # ### ######### ### ### ### ####### # ######### # ### # #
#   # # #     #     #     #   # # #     # #   # #     #   # #   #   #   #     # #         # # #     #
# ### # ######### # ### # ### ### ### ### ### # ### # ### # ####### ### ### ### ##### ### ###########
# # #     # #   # # #   # #   #     # #   #       # #         #       #     #         #         #   #
### ### ### ### # # # ######### ### ### # ### ######### # ##### ### # ##### # ##### ##### ##### ### #
#   #   #   # #   # # #     #   #   # # #   #         # # # #   #   # #   #       #   # # #         #
# # ####### # # ##### ##### ####### # # ####### # # ### ### ### # ####### ### # # ##### # ##### #####
# #   # #     #   #         #           # #     # #   # # # # # #     # # # # # #   # #     # #     #
# # ### # # # # ####### ### ##### ##### # # # ### ##### # # # ##### # # # # ### ##### ##### # ### ###
# # #     # #   # #   # # # #     #     #   #   #   # #   # #   #   #       # #   #   #     #   # # #
# ##### ####### # ### ### # # ######### # ### ##### # ### # ### # # ##### ### # ##### ##### # ### # #
#   #   #       #       # # # #   # #   # #   #       #   # #   # # #           #         #   #     #
# # # ####### # # ### ### # # # # # ##### ##### # # ####### # ### # ############# # # ### ######### #
# #     #     # # # #     #   # #     # #   # # # #       #       #     #         # # #   #   #     #
# ### ### ####### # # # ##### ##### ### ### # # ############# ######### ### # ##### ##### ### # # # #
# #     #   #   # #   #         #   # #       #   # #     #   # #         # #     # #   #     # # # #
### ### # # ### # ########### ### ### # # ####### # ### ### ### ####### # # # ##### # # ######### # #
# #   # # # #   # #   # #   # #   #     # #   #         #     # #       #   #   # #   # # # #     # #
# ### # ##### # ### ### # # # ### ### # ### ##### ####### # ### # ### ##### ### # ### # # # ####### #
#     #   # # #   #       #       # # #       #     #   # #   # #   #   #     # # #   #       #   # #
### ##### # ##### ### ##### # ##### # ########### ### ####### # ### ### ### # # # ### ######### # # #
#     # # #     # # #   #   #     # # # # #   #     #   #       #   #   #   # # #       #   # # #   #
### ### # ### ### # # ### ##### ### # # # # ### ####### ##### # # # ### ####### ####### # # # # ### #
# # # #     # # # # #   #   #       #         # #   #       # # # #   #   #     #   #     # #     # #
# # # ####### # # # ### # # ### ####### ####### ### ##### ##### # # ######### # ### ### ######### ###
#   # #     #       #   # # # # #         #                   # # # #       # #     #   #   # #   # #
# ### # ### ##### ### ### # # ### ##### ##### ### ####### ##### ### # ##### # ##### ### # ### # ### #
# # #   #   # #         # #   # #     # #     #       # #     # # # #   #   #   #     # # #       # #
# # # ### ### # ##### ####### # ########### ##### ##### ### # # # ### # ### ### ### # ### # ### ### #
#   #   #     # # #       #   # #     # #     #   #   # #   # #     # # #   #     # # # #   # # #   #
# ### # ####### # ##### # ##### ### ### # # ### ### ### # ### ### ##### # ##### ##### # ##### ##### #
# # # #       #   #     # #   # # # #     #   # #   # #     #   #     # #   #   #     # #   #       #
# # # # ##### ##### ##### # # # # # ##### ##### # # # ### ##### ### ### ### # ### ### # ### # ### # #
# #   #     # #   #   # # # #         # # #   # # # #   # #     # # #     # #   # #   #   #   #   # #
# # ### ####### # ### # # ##### ### # # ### ### # # # # # # ##### ### # ####### ### ##### ##### # # #
# # # # #     # # # # #   #   #   # # #     # #   # # # # #   #     # # #   # # # # # #       # # # #
# # # ### # # ### # # ### # ### ### # # ### # ### ##### ##### ### ##### ### # ### # # # ######### # #
#       # # # #   # #   #     # #   #     #       # #         #   # #   #       #   #     #     # # #
##### ### ### # ### ### # ######### # ########### # ########### ### ### # ####### ### # # # ##### ###
#   # #     # #         # # # #     #   #     # #   # #     #     #   # #   #         # # #   #   # #
### # # ##### # ### ####### # ### ####### ##### ### # ##### # ### # # # # ### ##### ##### ### ### # #
#     # # #   #   # # #   # #   # #   # # # # #             # # # # # #     #   # # # #     #       #
### ### # # ### ### # # ### # # # # ### # # # # ##### ##### # # ### ### ### ### # # # ####### ### ###
# #   #   #     #   #     # # #         # # #       # # # #     #         #       #       # #   #   #
# ### ####### ##### # # # # ########### # # # # ### ### # ### # ### # ####### ### ##### ### ####### #
#   #       #   #   # # # #   # #     #   # # #   # #   #     # #   #   #   # #   # # #   # #       #
### ### # # ####### ##### # # # # # ### ### # ### # ### ############# ### # # ##### # # ### ### ### #
#     # # # #     #     #   #   # #     # #   # # #   #             #   # #     #     #         # # #
### # # # ### # ### ######### # # # ### # ##### ### # ##### ### ### ##### # ######### ##### ##### # #
#   # # #     # #   #         #   # # #     #       # #       # #   # # # # #     # #         # # # #
# ##### ######### ### ####### ##### # ##### ##### # # ### ##### # ### # # ### ### # # ##### ### # # #
#       #   #   # #   # # #       # #           # # # #     # # #   #         #   # # #     # # #   #
### ##### # # ####### # # ### ##### ### ################### # ####### ##### ### ### ####### # # # ###
# #     # # #     #         # #     # # #   #                   #   # # #   #     # #           # # #
# # ### # # # ##### ### ########### # # # # # # ######### ##### ### ### ####### ### # ####### ### # #
#   #   # #         #     #         #     #   #   #           #       #             #     #     #   #
#####################################################################################################
