#####################
#       # # # # #   #
##### ### # # # # ###
# # #   # #   #     #
# # # # # # ####### #
#     #   #   #     #
### ######### # #####
#             # #   #
# ######### # # ### #
# #   #     # #     #
# # # ### ### ##### #
# # # # # #     #   #
# # ### # ##### # # #
# # #       #   # # #
# # ######### # ### #
#       # #   # #   #
##### # # ### # # ###
#   # # # #   # #   #
# ### ### ##### # # #
#     #           # #
#####################
