#####################
#           #   #   #
##### ##### # ### # #
#   # #   # #   # # #
# ### ### # ### # # #
# #   #         # # #
# # # ####### # # # #
# # # # # # # #   # #
# # # # # # # ##### #
#   #     # #   # # #
# ######### ### # ###
#   #               #
### ####### ### ### #
#       #   #   #   #
####### # # # #######
# #     # # #   #   #
# ### ######### # ###
#       # #         #
# ### ### # ##### ###
#   #   #     #     #
#####################
