###################################################
# #                     #       #     #   #       #
# ### ### ### ##### ########### ### ### ####### # #
# #   #   #   #           #     #     #     #   # #
# # # # ### ##### ########### # ##### ### ### ### #
#   # # #     #           #   # # #           #   #
# ### ### ############# # # # # # ##### ######### #
#   # #     #   #       #   # # #       #   #   # #
# # # ### ##### ##### # # ##### # # # # ### ### # #
# # # # # # # # # #   # # #   #   # # # #   #     #
##### # ### # # # # ### ##### # ##### ### ##### # #
#       #             #     # # #         #     # #
# ### ### ################# # ####### ######### ###
#   #   #   #   # #   #     # #   #   # #     # # #
# ### ##### ### # # # # ##### # # ### # ### # ### #
# #     #     # # # # #         #   #   #   #     #
# # # ### ### # # # ### ##### ##### # ### ### ### #
# # #   # #   #   #   #     # #     #   # # #   # #
# # ### # # # # # ### # ####### ##### # # # ### ###
# # #   # # #   # #     #     # # #   #     #     #
# # ############### ##### ### # # ##### ### ##### #
# #         # #   # #     # #       #   # #   #   #
# ### ### ### # # # # # ### # ##### ##### ##### # #
# #   # # # #   #   # # #   # # #   #   #       # #
### # # # # ### # ##### # ### # # ### ### ### #####
# # #   #   # # #   # # # #   # # #     #   # # # #
# ####### ### ####### ### ### # ##### # ####### # #
#   #     # #   #         # # # #     # #         #
### ### ### # ### ####### # # # ### ####### ### ###
#     #   #       #       #         # #   # #     #
### # ### # # ### ####### ##### # ### # # # # ### #
#   #     # #   # #           # #     # #   # #   #
####### ######### ### # ### ### ##### # # ### #####
#     #     #       # #   #   # #   # # # #       #
# ### ### ### # ##### # ####### # ##### # ##### # #
#   #   #     # #     # #   #   #   #   # #     # #
# ### ####### # ######### ####### ### ### #########
# #       #   #     #       #     # #   # #       #
### ####### ### ######### ### # ### ##### # ##### #
#       #   #         # #   # #   #   #   #   #   #
####### ### # # ##### # # ### ##### ### ######### #
#     # # # # #   #   # # #     # #         #     #
# # # # # ######### ### # ### ### ### # # # ### # #
# # #   # #   #     # #   #         # # # #     # #
# ####### # # ### ### # # ### ### # # # ######### #
#   #       #           # # #   # #   #       #   #
### # ### ########### ##### ##### # ### ### #######
# #     # #   #     # #   #   #   # # # # # #     #
# ### ### # # # ### # # # ### # ### # ### # # ### #
#       #   #   #   #   #       #       #     #   #
###################################################
