#####################
# # #     # #   #   #
# # ### ### # ### ###
#   #   #   # #     #
# ##### ### # ##### #
#       #     #     #
##### ### ### # ### #
#     #   #     # # #
# ####### ##### # ###
#     #     # #     #
### ### ##### # # ###
#     # # #   # #   #
# ##### # # # ##### #
#   #   #   # #   # #
# ### # # ##### # # #
#     # #       #   #
########### ### ### #
#     # #   #   # # #
# ### # ##### # # # #
#   #         #   # #
#####################
