###########
# #   #   #
# # # ### #
#   # #   #
# ### # # #
#   #   # #
### ##### #
#     #   #
# ##### ###
#   #     #
###########
