#####################################################################################################
#           #     #     #     #         #     #   #       #     #     #   #     #   #     #   # #   #
##### ### ### # # # # # # # ##### # ##### ##### # ##### # ### ### ### ### ### ### ##### # # # # # # #
#   #   #     # #   # # # # #   # #   #       # # #   # # # # # #   #   #   # # #   #   # # #     # #
# # # ########### ######### ### ### # ####### ### # # # ### # # ####### ### # # ### # ### # ####### #
# #       #     #     #             # # #         # # # # #   #   #       #     #       # #   #     #
##### ####### # ##### ### ##### ####### # ##### ### ### # # ##### ### ######### # ########### # ### #
#   # # #     #         # #   # #       #   #           #           # # #           # #       # #   #
# ##### # ### ### ### ### ### # # ######### # ### ####### ####### ### # # ### ### # # ### ####### # #
#       # #     #   #     # #           #   # #   # # #     #   #     #   #   #   #             # # #
# ####### # # # # # ####### # ##### ### ### ### ### # ### ### # # ### # ####### ##### ##### ### ### #
#         # # # # #         #     # # # #   # #   # #     # # # # # # # #     #     # #     #     # #
# ##### ####### ####### ####### ### # # # # # ##### # ### # ### # # ### ##### # ### # # # ### #######
#     #     # # #   # # #   #     # #   # # #       # # #   #   #   #   #       #   # # #   #   #   #
# ##### ##### # # ### # ### # # ### # ### ####### ##### # # # ### ##### ######################### ###
#   # # # #   # # # #   #   # # #   # # #     #   #     # #   #   #     #           #       #       #
# ### # # # ### # # ##### ### # ##### # # ### # ### ########### ####### ####### ### ### ##### ### # #
# #         #   #   # #       # # # #   # # #   #   #   #                         #     #     #   # #
# ### ####### # # ### ### # ### # # # ##### # ### ##### # ### # # ### ### ####### ### ####### # ### #
# #         # #     # #   # #   #   #     #   # # #   #   #   # # # # #   #   #   #   # #     #   # #
# # # # ### ####### # # # # # # # # # # # # # # # # # ########### # # ##### ##### # # # # ### #######
# # # #   #   #   # # # # # # # # #   # # # # #     # #     # # #   #   #     #   # # #   #     #   #
### ############# # # # ##### # # ### ### # # # ### ### ### # # ### # # # ### # ##### # ########### #
#   #       #       # #     # # # #     #   # # #         # #       # # #   #   #   # # #   # #   # #
# # ### ### # # ### # # ### ##### ######### ########### ####### # ##### ######### # # # ### # # ### #
# # # # #   # # # # #   # #   #     #     # # #   # #     #     # #   #     #     #             #   #
### # ### ####### # ##### ### # # ####### # # # # # ### # # # ##### # ### ##### ########### # # ### #
#   #   #     # #     #       # # #       # #   # # # # #   # # # # #     #   #   #     #   # #   # #
### ### ### ### # ### # ##### # # # ### # ### ##### # # # # ### # # ######### ### # # ### # # # # # #
# # #         #   # # #   #   # #     # # #     #   #   # #       #   #   #   #     # #   # # # #   #
# ### # ########### # # # ######### ##### # ### # ############# ### # # # # # ### ### ##### # # # # #
# #   #   #       #   # #       #     #   # #     #       #     # # # # # # #   # #     # # # # # # #
# ### ### # # # # # # ### ##### # ### ### ##### ##### ### # # ### ##### ####### ### ### # ##### #####
#   #   #   # # #   # #   # #   # #     # #     #   #   #   # #   #       #       # #   #   #     # #
# ### # # # ### ######### # ####### ##### # # ##### # ### ### # # ### ####### # # ######### # ##### #
#   # # # # #   #   # #   # # #     #   #   #   #   # #     #   #   # #   #   # # #       # #   #   #
# ##### ##### ##### # # ### # ##### # ########### ### # # # ####### # ### # ##### # ####### ### ### #
#     # #   #       # # #   # #   #         # # # # # # # # # #               # # # #   #     # #   #
# ####### # ### ##### # # ### # ########### # # # # ### # # # ### ##### # ### # ### # ### ### ### ###
#   #     #         # #   #     #           #   #       # #     # # # # #   # # #       #   #     # #
# ### ########### ### ### # ##### # ######### ### ### ##### ### ### # ### ### # # # # ### ##### ### #
#             # # #   # #     #   # #   #   #   # # #   #   # #     #   #   #   # # #   # # #       #
# ########### # ##### # # # # ### ##### # # ### # # # ### ### ### ##### ### ####### ### # # ##### # #
#   #           #   # # # # #   #         # #     #     # #   #   #   #   # # #     #   #   #     # #
### # ### # ### # ### # # # ### # # ### ### # # ### ##### # # ##### ##### # # ### # ### ### # ### ###
# # #   # # #   #   #     # #   # # #     #   # #     #     #   #           #   # # #   #   # #   # #
# ######### ### ### ### ### ##### ### ### # ### ### # ####### ### ##### ### # # # # ########### # # #
# #   #       # #         # #     #   #   # #   #   # #   #   # # # # #   # # #   #   #         #   #
# # ######### ### ##### ### ### ####### ##### ######### # ##### # # # # ### ### # # ##### ####### # #
# #   # #   # # #   #     # # #       # #   #   #     # #   #   # #   # # #     # # #     #     # # #
# # ### # ### # # ########### ####### # # ##### # ### ### # # ##### ### # ### ####### ######### # # #
#         #     #         #   #       #   #     # #   # # # #   #       #     #   # #   #         # #
# # ### ### ######### ####### ### ######### # ### ### # ### # ### # ### ### ### # # ##### # # ### ###
# #   #         #   #         #     #       # #   #         #   # # #     #   # #     #   # #   #   #
# ############# # ##### ### ### ### ### ##### ### # # ### ##### ######### # # ##### # # # ##### ### #
# #   # #             # #   #   #     #     # # # # # #   # # # #       # # # # # # # # #     # #   #
# # # # # ####### ##### ##### ##### ### # ### # # ### # ### # # # ### # ##### # # # ####### ### ### #
#   # #   #   #   # # # # #     # # #   #   # #     # #   # #     #   # #   #               #     # #
# ##### ### ### ### # # # ####### # ##### ### ### ##### # # # # ### ####### ### # # ### ##### # ### #
#     #   #     #     # # # #   #   #   # #         #   # # # # # #   #     #   # # # #   #   # #   #
# ####### ### # ### ##### # # # ### ### ### ####### ### # # # ### # ##### ####### ### ########### ###
# #   #   #   # #   #         #   # # #   # #       #   # #   # # #         # #   #                 #
# # ##### # ##### ### ##### ### # ### # ########### # ### # ### # # ######### # ############### # ###
#   #   # # # #     #   #     # #   #     #       # # # #     # #   #   #         #       #   # #   #
### # ##### # ### # # ########### ### ### ##### # ### # # ### # ### ### # ######### ### ### # # #####
# #     # #   # # #   #   # #     #     #   # # #     #     # #     #       #       #   #   #   #   #
# ### # # ##### ##### ### # # ### ### ### # # ### ####### ####### # # ### ### ############### ### ###
#     #   #     #   # #         #     #   #   #   #       # # # # # # #     #   #             #     #
# ### # # # ##### # # ######### ####### ############### ### # # ### # ### ##### # ##### # ####### # #
#   # # #   #     #     #     #   # #       #   #   #         #     # # # #   #     #   #     # # # #
# ########### ####### ### # # ##### # # ##### # # ##### # ####### # # # ### ##### ### # # # # # ### #
#       #       # #   #   # #         #   # # #         # #       # #     #     # # # # # # #       #
# ####### ####### # ######### ########### # # # # # # ### ####### # ### ####### ### # ##### ### ### #
#   # #       # #   #   #   # # #     # # # # # # # # #       #   # # # #     #       #   #   # #   #
### # # # # ### ### # ### ##### # ##### # # ####### ### ####### ### # # ### ############# ######### #
#     # # #   #   #   #     #   #     # # #     #   #     # #   #     # # #     # # #     # #       #
############# # # ### ##### # ##### # # # # ### # ### ##### ##### # ### # ### # # # ### # # # # ### #
#   #     # # # #   #       # #     #   #   # # # # # # #   #   # #   #     # #     #   #   # #   # #
# ##### # # ####### # ####### # # ### ##### # ### # # # ### # ### ##### ####### # ####### ##### ### #
#     # # #   # #       # # # # # # #       #     #     # #     # #   # # #   # #       #     #   # #
### # ### # ### # # ### # # # ##### # # ### # # # ### ### # ####### ### # ### ######### # # ##### # #
#   # #         # # # #   #   #       # # #   # # # #   #     #   #   #           # #   # #       # #
# ##### # ### ####### ### # ########### # ####### # ### # ### # ### # ############# # ##### # ### # #
#       #   # #     #     #       # #       #         #   #   # #   # #       # #       # # #   # # #
### ######### # ### ### # ##### ### ### ####### # # ### ### ### # ### # ##### # ### ### # # ### ### #
#         # #     #     #       #       # #     # #   #   #   #   # # #     #         #       # #   #
# # ### ### # ### # ##### ##### ######### # ##### ### ### ### ##### # # ### # ##### ##### ####### # #
# # # #   # # #   #   #     #   #             # #   # # #   #       # #   # # #     #   #       # # #
# ### ### # # ############### ### ######### ### # # # # ### ####### # ### # # ####### # # # ### #####
# #     # # #   #   #       #   # #     # #   # # # # #         # #     # # #   #   # # # # #     # #
# # # ### # # # # ### ### ### ### ##### # ### # # ##### ##### # # ### # ### ##### # # ### ##### ### #
# # #     #   # #   # # #       #   # #     #   # # #   #   # #   #   # # #       # #         #   # #
# # ##### ### # ### # # ####### ### # ### ####### # # ##### # ####### # # # ### ### # ##### ##### # #
# # # #   #   #     #       # #   #   #     #   # #     #   #   #   # #   # # # #   # #       #   # #
# ### # ########### ### # ### ### ####### ### ##### # ### ####### # ### # ### ##### ######### ##### #
# # # #       #   # # # #   # # # #         #       #       #     #   # # #       #   # #   # #   # #
# # # ##### ### ##### ##### # # ### ####### ### ##### ######### ##### ##### ##### ### # ### # # ### #
# #   #   # # # #   #     #       #     #     # #   # #   #   # #           # #     # # # # #   #   #
# ### # # # # # ### # ####### # ### ### # ### ##### # # ### # # ### ##### ### # ##### # # # # # # ###
#     # #         #           # #   #   #   #               #   #       #   #   #         #   #     #
#####################################################################################################
