#####################
#     #       # #   #
# ### # ####### # ###
# #   # #         # #
# # ### # ##### # # #
# #     # #     #   #
# ### # ##### ##### #
# #   # # # #   # # #
# ##### # # ### # ###
# #         # #   # #
# ### ### ### ### # #
# #   # #       # # #
# # ### # ##### # # #
# #     # #         #
# ########### #######
# # #   # #         #
# # ### # # ##### # #
#   # # # #     # # #
### # # # # # # ### #
#   #       # # #   #
#####################
