###########
#   #     #
# ####### #
#     #   #
# ####### #
#         #
# ####### #
# #     # #
# # # # # #
#   # # # #
###########
