###########
#     #   #
##### ### #
# #   # # #
# # # # # #
#   # #   #
# ##### # #
#       # #
# ### ### #
# #   #   #
###########
