#####################
#   #             # #
# # ### ### ### # # #
# #   #   # #   #   #
##### # ######### # #
#   #     #   # # # #
### ### # ### # ### #
#       # #       # #
# ####### # ####### #
# # #         #   # #
# # ##### ##### # # #
#       # #   # #   #
######### ### ##### #
# #     #     #   # #
# # ### ##### # #####
#   #     #   #     #
##### ##### ####### #
#     #     #   #   #
# ######### # # # # #
#             #   # #
#####################
