#####################################################################################################
#   #       #     #       # #         #                         # #   #   #             #           #
# ### ##### # # # ### # ### # ### # ### ### ### # # # # ### ### # ### # # ### # ##### ### ######### #
#   #   # # # # # #   # #   #   # #       #   # # # # #   # # # # #     #     # #             #   # #
### # ### # ### # ### ### # ##### ##### # ### # ##### ##### # # # ######### # ######### ### ##### # #
#   # #         #   #   # # #   # #     # # # # #       #   #     # # # # # # #       #   # # # #   #
# ################# # ##### # # # ##### ### ### # ##### # ### # # # # # # # ##### ######### # # ### #
#   #   # #   #   # #       # #       #   # # # # #   # # # # # # # #               #     #   #     #
# ##### # # # # ### # ### # ##### ### ### # # # ### # # # # ### ### # # # # ### ### # ### ### ##### #
#         # # #     # #   #   #     # #   #   #   # #   #   #   #   # # # #   #   # # #     #   #   #
# # ### # # # # ####### ############# ##### ### ########### ##### # ####### # ##### # ############# #
# #   # #   #   #             #   #   #               #   # #     #   #     #     #           # #   #
# ### ####### # # # # ####### ### # ################### ### ### # # # # ### ######### ####### # # ###
# #     #   # #   # #   # #             # #         # #     # # # # #     # # #   # #     #   #   # #
# ### ##### # # ##### ### ### ### ##### # # ####### # ### # # ### # ##### # # # ### ##### ####### # #
#   # # #     # # #   #         # #   # #     #   #   #   #       #   #   # #     # # #       #     #
### # # ### # # # # # ### ### ### # ##### # ### ### ##### ############### # # ##### # # #############
#   # #   # # #   # # #   # # #   #   # # #   #         # #   #   #     # # #           #   #       #
### ### # ### ######### ### # # ##### # # ########### ##### ### # # ### # # ######### # # ####### # #
#     # #   # #   #   # # # # #   #   # #     #     #     # # # # #   #   #   #   #   # #       # # #
# ##### ### # ### # ### # # ### # ### # ##### ### # ####### # # # ### # ##### # ##### ### # ### # # #
#   # # #           # #   # # # #       #     # # #   #     # # #   # # #         #     # # #     # #
# ### ### ####### # # ### # # ####### # # ##### ##### # ##### # ### # # # # ##### # # ##### # ### ###
#   # #   #       #   #     # #   #   #               #         #     # # #   #   # # #     # #   # #
# ### ##### ### ####### ### # ### # ##### # ####### ############### # # # ############### ### ### # #
#     #   # # #   #     #   #         #   # #   #     # #           # # # # # # #     #   #   #     #
##### ### ### ####### ### ############### ##### ##### # ####### ##### ### # # # # # # ### # ### ### #
#   #             # # # # # #   #     #           #   #   # # # #     #   #   #   # # # # # # # #   #
# ####### # # # # # # # ### ### ### # ##### ####### ### # # # # # # # ### # ### ### ### # ### ##### #
# #   #   # # # #   #     #         # #   # # #       # # #     # # #   #   # # # # #       #   #   #
# # # # # # ############# # ### ### # # ### # # ##### # ######### # ######### ### # # ####### ##### #
#   #   # # #   #   # # # # #   #   #     # # #     # #     #     # #   #               #   # # # # #
# ############# # ### # ### # ### ### ### # # # ##### # # ### ##### ### ######### ### # # ### # # # #
#       # #       #   # #   #   # #     #   # # #     # # # #     #         # #   # # #   #       # #
# ##### # ### # ### # # # ####### ##### ##### ##### ### ### ##### ##### ##### # # # # # # ### # ### #
#     #       #     # #         # # #       # # #   #   #     #       # #       # #   # #   # #   # #
# # ##### ##### ################# # ### ### # # ##### # ### # # ### # # ### ############### ### # ###
# # #   # #   # #     #     # #     # # #     # #     # # # # # # # # # #   #     #     # # #   # # #
# ### ####### # # ### # ### # ####### # ####### ### ### # ### # # ### ### ### ### ### ### # # # # # #
#     # #         #   # #   # #   # # #     #         # # #     #     #   # # #   #   # #     # #   #
### ### # ##### ######### # # # # # # ##### # # ##### ### ### ##### ### ### # ### # ### ### ####### #
#   #   #   # #         # # # # #     #       #   #   # # #     #     #   # # #     # #   # #     # #
# ##### ##### # ####### ### # ### # ####### # # ####### # ########### # # # # ##### # # # ### #######
# # #   #     #     #         # # # #     # # #     # #     # #   #   # # # #   # #   # #   #       #
# # # ####### ### ##### ##### # # # # ##### # ##### # # ### # # ######### # ### # # # ##### ##### ###
#     #   #   # # #       #   #   #     #   #     # #     #   #       #   #     #   #             # #
# # ##### # # # # ############# # # ############# ### ######### # ####### # ### ################### #
# #       # # # # # #           # # # # # # #                 # # #   #     #   #   #           #   #
# ####### # # # # # # # ############# # # # ####### # # # ### # # # ### ########### # ### ##### # ###
#   #       # #     # #   # #       #           # # # # # # # # #               #   # # # #   #     #
######### # # ### ####### # # ### ##### ##### # # ### # # # # # ### # ######### # ##### # ### # # # #
#   #   # # #   # #   #         # #       #   # #     # # #       # #     # #   #   # #   #   # # # #
# # # ### ##### ##### ### ### # # ####### # ##### ##### ### # ##### ####### # ##### # # ### ### #####
# # #   # # #           # # # # # #   #   # #     #     # # #     #   #   # #   # #       #     # # #
### # ### # ### # ####### # ### ### ### ### # ######### # # ### ### # # ### ##### ##### # # # ### # #
#   # #   #     #   # #   # #     #     #           # #   #   #   # # #       #         # # #     # #
# ### # # # ####### # ### # # ### # # # ### ##### # # ### # # ### ####### ##### ########### # ##### #
# #     # #   #     #   # #   #     # # # # #   # # # #   # #   #             #   #     #   #   #   #
# # ### # ### # ##### ############# # ### # ### ### # # ##### # ####### # # ### # ### # ######### # #
#   #   # #   #     # #       #     #   # # #       # # #     # #   # # # #   # # #   # #         # #
# # # ### ### ####### # ##### # ####### # # # ### # # # ######### ### # ##### # ### # ### ##### ### #
# # #   # #   #     #       #     #     #   #   # #   # #       #   # # #         # #   #   #   #   #
# ### # ####### ### # ### ####### # ####### ##### ### # ### ### ### # # ##### ### ### ####### #######
#   # #       # #     # # # #     #       #   # #   # #   # #     #     #   # # # # # # # #       # #
### ### ### # ######### ### # ### # ### # # # # # ### # ##### ##### ### # ### # ### # # # # ##### # #
#   # #   # #   # #   #     #   # # #   # # # # # #   # #   #     #   #     # #     #     # #   #   #
# ### # ### ##### # # # ### ####### ##### # ### # ##### ### ### # ######### # ### # # # ### # ##### #
#     #   #         # # # #     #   # #   # #     # # #         # #     #   # #   # # #       #   # #
# ##### ######### ##### # ##### # ### # ### ####### # ####### ### ### ### ### # # # # # # # # # # # #
# # #   #   #   #   # #     # # #     #   #   # #   # # #   #   #   #   # # # # # # # # # # # # #   #
# # ### ### ### # ### ### ### ########### # # # # # # # ### ### ### # ##### # ##### ### ######### ###
#   #   #     #       # #   # #   #       # #     #   #           #   # #       #           #       #
####### ### ####### ### # # # # # # ########### ### ### # # ########### # # # # # ######### ####### #
#     #   #     # #   #   # #   #     #         #   # # # #     #   #     # # #   # #     #     # # #
# ### ### # ### # ### # # ### # ######### ### ####### # ### ### ### ### # ### # ### ### ####### # # #
# #   #     #     #     #   # #     # # #   #   #   #   #   #     # # # #   # #       #   #       # #
# ####### ##### ##### ########### ### # ### ### # ######### # # ### # ##### # # # # ##### # ### ### #
#     # #     #   #   #         # #           #   # #   # # # #       # # # # # # # #   #   # # #   #
# ### # ##### ##### ### ####### ### ### ##### # # # ### # ##### ### ### # # ### ### # # ### # ##### #
# #     #     #   #     #     #   # #   # #   # # #           # # # # #       # #   # #   #   #   # #
# ### # # # ### ### ######### ########### # ### # ##### ##### ### # # # ### # ### ### ##### ##### # #
# #   # # #       #       #       #       # # # # # # #   # #   #     # #   # #     #     # #   #   #
# ####### ### ########### ##### # # ### ##### ### # # # # # ##################### # # ##### ### #####
# #   #   # # #   # #     #     #   # #   # #     # # # # #     #         # #   # #   #       #     #
# # # # # # # # # # ### # # # ####### # ### # ### # # ### # ### # ### ### # ### ### ### ####### ### #
#   #   #   #   # #     # # # #     # # #   # #   # #     #   # #   #   # # #   #   #         # #   #
# ##### # # ######### ### # # ### # # # # ##### ### # ### ### # # ####### # # ### # # ####### # ### #
#     # # #     # #   # #   #     #   #       # #   #   # #   #   #   # #   # #   # # # #   # #   # #
### # # ##### # # ### # # ### ######### ##### # ### ##### ####### # # # ### # # ### ### # ### ### # #
#   # # #   # #   #     #   #   #           # #             #       #     #       #       #   #   # #
##### ### # ######### ######### ### # ########### ##### # ##### ####### # ############# ########### #
#   #     # # # #     #       # #   #   #     #   # #   # #     #     # # #       #         #       #
# # ####### # # ####### ### ### ### ### ### # ##### # ##### ####### # ### # ### ####### ### # ##### #
# #   # #     # #       #   #   # # # #   # #   #     # #   #       # #   #   # #   #   #   # #   # #
# # # # # # # # ### # ### # # ### # # ### ### ##### ### ### ### ### ### ### ### # ##### ##### ### # #
# # # #   # #       #   # # # # #     # # # #     # #   # #     # # #   #   # #   #   #   #   # #   #
### # ##### ########### ##### # ##### # # # # # ### # ### # # # # # # # ### # # ##### # # ### # #####
#   # #   #     # # #       # #   #   # #   # # #   #       # # # # # # # # #   # #   # #     # #   #
# ### # # # ### # # ####### # ### # # # # ### ### # # ####### # # ##### # # ##### # ### ##### # ### #
#   #   #   #             # #     # #   #   #     # #   #     # #                   #       #       #
#####################################################################################################
