###########
#         #
# ### ### #
#   # #   #
# # # ### #
# # # #   #
# ####### #
# #     # #
# # ### ###
#   #     #
###########
