#####################
#       #   #   #   #
# ### ### # ### ### #
# # # #   #   #     #
# # # ### ### ##### #
# # #   #   #     # #
### ### # # ##### # #
#   # # # #     #   #
# ### # ### #########
#     # #       #   #
### # # ##### # ### #
# # #   #     # # # #
# # ### ####### # # #
#   # #     #       #
##### # ### # # ### #
#       #     # #   #
##### ####### #######
#   #   #       #   #
# # # # ##### # ### #
# #   # #     #     #
#####################
