#####################################################################################################
# # #     #   # #             #         #           #         #                 #         #   #     #
# # ##### # # # # ####### # ### ### # ####### # # ##### # # ######### ##### ##### ##### # # ### ### #
# # # #     #   # #     # # #   #   #   #     # #   #   # # #         #     #       #   #     # #   #
# # # # # ### ### # ### ##### ### ### # ######### # ##### ### ################# # ########### # ### #
#       # #     #     # #       #   # # # # # #   # # #             # #     #   #   #       # #   # #
# ####### ### # ### ### ############# # # # # # # ### ### ########### # ### # ##### ### ### ####### #
#   #     # # # # # #                 #     #   #             # #     # #   # #     #     # #   #   #
##### ##### ### # ##### ##### ####### ### # # ############### # ### # # ### # ##### ### # ##### ### #
#         #   #   #   #     #     # #   # # #   # #   #   #     #   #     # #     #     # #       # #
# ### ##### # ##### ####### ### ### ### # # ##### # # # ### ### # # # # ######### # # ### # # # # # #
# # # # # # # #         #   # # #   #   # #         #     #   #   # # # #   #     # #   #   # # #   #
# # # # # # ### # ### ### ### # ### # ### ### # ##### ### ##### ### ####### # ##### ### ##### ### ###
#   # #   # #   # #       # #     #   #     # # #   # # #   # # #       #   # # #   #   #   #   #   #
# ### ### # # # ### # # ### ########### ### # # # # # # ### # ### # # # ### ### ####### # ##### # # #
#   #   # # # # # # # # #     # #     # # # # # # #   #     #     # # #     #   #     # # #   # # # #
# # # # # # ### # # # ##### # # ### # # # ##### ####### ##### # ####### ### # ####### # # # ### # ###
# # # #     # # #   #   #   # #     # # #       #             # # #       # # #     #       # # # # #
# ####### ### ### ##### ##### ### # ##### # ########### ### ##### ##### ### # # ##### # ##### ### # #
#       #             #         # # #     # # #   # # #   # # #   #     # # #         # # #   # # # #
# ### # ##### # ### ### ### ### ### # ####### # ### # # ### # # ######### # ### # ### ### ### # # # #
# # # # # # # # # # # #   #   # #     # #                 #           #       # # # #   #         # #
### ### # # ##### # # ##### ### ### ### ### # # # ####### ######### ### ##### ##### ### ##### # ### #
# #               #   #     #   #   # #     # # #   #       # # # #   #     #             #   #     #
# # ####### ### ### ### ##### ### ### ####### ####### ##### # # # ### ########### ##### ### ### #####
#       #     # #   # # #     #   # #     # # #           # # #   #   # #   #         #   # #   #   #
# ####### ##### # # # ##### ### ### # ### # ### ######### # # # # # # # # ### # ### # ##### # # ### #
# #   # # # # # # #     #   # # # # #   #   #     #       # #   # # #     # # # # # #     # # #     #
# # ### # # # # ######### ### # # # ####### # # ##### # ##### ##### ### ### # ### ####### # ####### #
#   #       # #   #   #     # #     #   #     # # #   #       # #   # #   #   #     #     #   # #   #
# ####### ### ### # # # # # # ######### # # ### # ### ####### # # # # ### ##### ####### ### # # ### #
#       #     #   # # # # #     #     # # # # #   # #   #   # #   # #   #       #   #   #   #   #   #
# ##### # # ### ##### ##### # # ### ### ##### ### # # ##### ##### # # ### ######### # ######### # # #
#   #   # #   #         #   # # #   # # #           #   #     # # # #   #       #   # # #   # # # # #
### # ### # ################### ### # # # # ### ######### # ### ####### # ##### # ##### # # # ### # #
# # # #   #   #   #   # #           # #   #   #     #     # #         #     #   #   #   # #       # #
# # # # ##### # # ### # # ##### ##### ### ### ##### ##### ### ####### # # # ##### ### ####### #######
#   # # #   #   # # #     # # #   #     # #   # #           # # # #     # #                 #     # #
# ### # ### ####### ### ### # # ##### # ##### # # ######### # # # ### ##### ### # ### ############# #
#   # #       # #           # #     # #   #     #       #   # #       #       # # #     #   #   #   #
### ####### ### # ##### # ### ### # # # ##### ### ####### ####### ### ##### ########### ### ### ### #
#   #   #     #   # #   # #   #   # # #     #   # #   #     #   # # # #     #     #     #   #   #   #
### ### ### ####### # # # # ### ### # ####### # # # # ### ### # ### ######### ####### ##### # # ### #
#   # # # # # #       # # #       #   # #     # #   # #   # # #         #             #       #     #
# ### # # # # ##### ### ####### ####### ### ######### # # # ##### ### ####### ##### ### ### # # # ###
#   # # #   #   # #   # #           #       #       # # #   #       # # #   # # #         # # # #   #
# # # # # ##### # ### ### ########### ### ##### ### ##### # ######### # # # # # ### ####### ### ### #
# #   #       # #     # #           # #     # # #     #   # # #       #   #       #     # #   # # # #
##### ####### # ####### ##### ### # ### ### # # # ##### # # # ### # ##### ##### ### ##### # ##### # #
#   # #   #             #     #   #   # # #   # #       # # # # # #   #     #   #     #   #       # #
# ### # ### ############### ### ### # ### # ####### ##### # # # # # ### ##### ####### ### ### ##### #
#   # #   #       #           # # # #   # # #       #     #   #   # #     #       #     #     #   # #
# # # ### # ### # # ### ######### # # ### ### ##### # # ### # ### # # # ### ############### ### ### #
# # #   # #   # # #   # # #         #   #     #   # # #   # #   # #   #   #   # # #       # # # #   #
### # # # ### ### ####### ####### ### # ##### # ### ### ### # # ##### # ##### # # # ####### # # ### #
#   # # #     #     #     # # #     # #   #   # #   #   # # # # #     # # #   #     # #   #   # #   #
# ##### ####### ### ### ### # # # ### ####### # # ####### # ####### ##### # ### # ### # # ##### # ###
#     # # #   #   # #           #   #   # #     #     #   #   # #   #           #       #   #   #   #
# # # ### ### ### # ####### # ### ####### ####### # ### # ### # # # # # ### # ######### ##### ##### #
# # #   #   #     #   #   # #   # # # #   #       #   # #   #   # # # #   # #       # #         # # #
# ######### # ##### ### # ##### # # # ### ##### # ### # # # ####### ### ########### # ### ### ### # #
#                 # #   #   # # # #     #   #   #   #   # #       #   #   #       #   #   # #   #   #
############### # ### ##### # ### ##### ### # ####### # # ### ### ######### ############### ### ### #
# #       #     #       # # #   #     #   # #   # #   # # #   # #   #     # # #         # # #   #   #
# # ### # ### ####### ### # # ### ### # # # ##### ### ### # ### ####### ### # # # ####### # # # # # #
#   #   #   #       # #   #     # #   # #         #     # # # #   #     #       # #   #   #   # # # #
##### ##### # ##### # # ##### ############# ##### # ### ### # # # ### ##### ####### ### # ######### #
#         #     #   # #     #         #     #   #     # #       #           #   #       # #   #   # #
# ##### ############# ##### ####### ### # # # # ### ### # ### ### # ##### # # # ##### ### # ### ### #
# #           #           # #     # # # # # # # #   #   #   #   # #   #   # # #   #     #         # #
##### # ####### ### ####### ##### # # ##### # # # ### # # # ##### # ########### ### ### ########### #
#     # # #   #   #         #     #   #     # # # # # # # #   #   # #     #   #     #   #   #       #
# ##### # # # # ############# ####### ######### # # # # # ### ### ####### # ### ### # ### # ##### ###
# #   #   # # # #   #           # # # #     #       # # # # #   #   #           # # # #   # # #     #
# # # ##### ### # ##### # ##### # # ### ####### # ### # # # # # ### # ####### ### ### # ##### # # # #
# # # #   # #         # #     # # # # # # # #   #   # # # # # # #   #   # #     #   #     #   # # # #
##### ### # # # ##### # # ##### # # # # # # # # ####### ### # ####### # # ####### # ### # # # # ### #
# # #       # # #   # # # # #     #   # #     # # #   #   #     #   # # #   #     #   # #   #   #   #
# # ####### # # # ### # ### # # ### # # ### # # # ### ### ### # # ####### # ### ####### ### # ##### #
# #   # #     #   #     #   # # #   #     # # #       #   #   #       #   #   #   #   # # # # #     #
# # # # # ##### # # # ##### # ######### # # # ### ##### # ######### ######### ### ### # # ######### #
#   # # #   #   # # #     #       #     # # #   # #     # #       #   # #   #   #               #   #
# # ### # ##### # ### ######### # # ### # # ### ### ### ##### ##### ### ### # # ### # ### # ##### ###
# #   # # #     #   #       # # # #   # #     # #   #   #       #       # #   # #   #   # # # #     #
# ##### # ### ### ### ### # # # ### ####### ### ####### ####### # ####### # ##### # ##### ### ### # #
#     #   #   # # #   #   # #     # # # #   # # #     #   # #             #   #   # #     #   #   # #
### # # ##### # # # ####### ######### # # # # # # ### ##### # ##### ##### # ########### ##### # ### #
#   #     # # #   #   #       #   # # #   # #   # #         #   #     # # #   # # #     #   #   # # #
# # ### ### # ### ##### # ##### # # # ####### ### # ####### ##### # # # ##### # # # ##### ### ### # #
# # #     # #   #   #   #       # # #       #     # #   #       # # #       #   # #         #     # #
# ##### ### ####### # ########### # # # ######### # # ########### ##### ####### # # ##### ##### # ###
#     # # # #       #   # # # # # #   # # #       # #   #   # # # #     #     # #   # #   # # # #   #
### # ### # ### ### ### # # # # # # # # # # ### # ### # ### # # # ### ### # ### ### # # ### # # ### #
#   #   #   #   #     #   #   # # # # #       # #   # #     #   #   # #   # # #   # #       #   #   #
# ######### # ### ####### ### # ############# ##### # ### ##### ### ### ##### ### ##### ####### # ###
#   #   # # #   #   #       #   #           # #   #     #     #         #         #   #     #   #   #
# # # # # # ### ############# ############# # ### ### ####### ### ##### # # ##### # ########### # ###
# # # #       #     # #   #       #       #   #   # # # # # # # # #     # #     # #     #   # # #   #
# # # # # ########### ### # ### # # ##### ### # ### # # # # # # # # ##### ### # ### ##### # # ##### #
# #   # #     #               # #   #           #       #     #   #       #   # #         #         #
#####################################################################################################
