###################################################
# # #           #             #   #       #       #
# # # # ### # ### ##### ##### ### ##### # ### ### #
# #   #   # # # #   #     # #           #   #   # #
# # # # # # # # # # ### ### # ### ####### # ##### #
#   # # # # #   # # #   #     #       #   #     # #
# ### ######### # # ### # # ####### # ####### ### #
#   # # #     #   #   # # #     #   # # #   # #   #
### ### # # ####### ### # # ##### ##### # ####### #
#       # #   # # # #   # # #         # #     #   #
# ####### ##### # ##### ####### ### ### # # ### ###
# # #             #       #   # # # #   # #       #
# # # ########### ######### ### # ### ### # ### # #
#   #   # #   #   #     #   # #       #   #   # # #
# # ### # ### # # ##### # ### # ############# ### #
# #       #   # #     #               #     #   # #
### ### # # ##### ### # ############# # ### ### # #
# #   # #   #   #   # #   #       # # #   #     # #
# # ########### ### ### ### ##### # ### ######### #
#   #         # #   # # #   # #       #   # #   # #
# ### ##### ### # ### ##### # ##### ### # # # ### #
#       # #   # # #   #         #     # #     #   #
### # # # ### # # ### # ####### # ##### ### ### # #
#   # #     #   # #         #   #   #   #     # # #
# # # ############# # # # # ##### ########### #####
# # #         # #   # # # #     # # #             #
# ####### ### # # # ####### # ##### ########### ###
#       # # #     #   #   # #   #           # #   #
# ##### ### ##### ####### ### ##### ####### # ### #
# #     # #     # #   # #       # # #   #     #   #
##### # # # ### # ### # ### ### # # # ##### ##### #
#   # # # # #     #     # # #   # # #       #     #
# ##### # ### ### ### # # # ### # # # ### ### ### #
#         #   # #   # # # # #     # # #     # #   #
# ##### ####### # ### # # # ############# # ##### #
# #   # #   #   #     # #   #     # #   # # #     #
##### ### ### # # ##### ##### ##### # ### ### ### #
#     #       # #   # #   #     #   #         #   #
### # # # # # ##### # ### # # ### ##### ####### # #
#   #   # # #     #     #   #       #       # # # #
# # ############# # ### ##### # # ### # ##### # # #
# #   # #     # #   # # #     # # # # #       # # #
# ### # # # ### ### # # # ######### # ##### ### # #
#   # # # #   #       # #     #       # #   #   # #
### ### ##### # ########### # ##### # # ### ##### #
# #     # # #     #   # #   # # #   #     #   #   #
# # ##### # # # ##### # ##### # ############### ###
#       # #   #       #           # #   # #   #   #
####### # ### # ### ### # ##### # # # # # ### ### #
#           # #   #   # #   #   #     #           #
###################################################
