###################################################
#   #   # #           #           #           #   #
# # # # # # ########### ######### # ### # ### # # #
# #   # #         # #   # # #     #   # # #   # # #
# ##### # # # ### # # # # # ### ##### ### ##### ###
#     # # # # # #     #   #     # #     # # #     #
# ### # # ### # # # # ########### ##### ### # ### #
# #   # # # #   # # #   # #   #     #   #     #   #
# # ### # # ####### ### # # # # ### # ### ##### # #
# #   #     #     #   # #   #   # #   # #   #   # #
##### ### ### ### ### ### ####### # ### # ### ### #
#     #       # # #   #   #     # #   # # #   # # #
# ### ### ### # ######### ### ### ##### ##### # # #
#   # # # # # #     # #                   #   #   #
# # ### # # # ### # # # # # # ### # ##### ### ### #
# # #   #   # #   #     # # # #   # #         #   #
# # # ### # # # ##### # ### ### ##### ##### #######
# #     # # #   #     #   # #   # #   # #       # #
# ### ### ##### ########### ### # # ### ####### # #
# #   #       #   # #     # # # # # # #       #   #
# ##### ########### ### ### # # # ### # # ####### #
# #         #     #     # #   #   # #   #         #
##### # # # ##### # ##### ##### ### ### # ##### ###
#   # # # #               # # #   #   # # # # # # #
# ### # ### # ##### ####### # ####### # ### # # # #
#   # # # # # #   # #     #       #   # #       # #
### # # # ##### # # # ########### # ### ##### ### #
# #   # # #   # #   #   #   # #   #       #   #   #
# ##### # # # # ### # # # # # # ####### # ##### # #
#     # #   # # # #   # # # #         # #     # # #
# ### # # ##### # # ### ### ### # ### ####### ### #
#   #     # #   #     # #       #   #     #   # # #
######### # ##### # ##### # # ####### ##### ### # #
#       # #   # # #       # # # #   # #   # #     #
### # # # ### # ####### ##### # # # ##### # ### # #
#   # #   #       # #   #   #   # # # #         # #
# ### # ### ####### ### # ### # ### # # ##### ### #
#   # # # # #     #   # #     # #   # #   # # # # #
# ####### # # ####### # ### ##### ### ##### ### ###
#     # #     #         #         # # #   # #     #
# ### # # ####### # # # ##### ##### # # ### # ### #
# #     #     # # # # #   # #   #     # # #   #   #
# # ##### ##### # # ##### # ### ### ### # # ### ###
# #   #       #   #   # # # # #       # # # # # # #
# ### # ##### # # # ### # # # ####### # # # # # # #
#   #     #   # # #   #   #     #     #     #     #
# ######### # # ### # ### # # ### ##### # ####### #
# # # #     # #   # #   # # #     # #   #     #   #
# # # # ##### ########### # ##### # ######### # # #
#     #   #   #           #     #             # # #
###################################################
