#####################
#   #     #     #   #
# ##### # # ### # ###
#   #   # #   #   # #
# # # # ### # ### # #
# # # # #   # #     #
# # ### # ##### # # #
# #     #   # # # # #
# ##### ### # # #####
#   #     # #       #
# ######### ####### #
# # #       #       #
# # ### ### ####### #
# #   # #         # #
# ### # # ### ##### #
#   #   #   # # #   #
### # # ##### # # # #
#     # #   # #   # #
# ### ### # # ##### #
#   #     # #   #   #
#####################
