###########
# #     # #
# ##### # #
#       # #
# ####### #
# #       #
# ##### ###
# # #     #
# # # #####
#         #
###########
