###################################################
# #   #   #     #   #   #               #         #
# # ##### ### ##### ### ### ##### # ### # ### # # #
#   #               #       # #   # # #   # # # # #
# ##### # # ### # ### ### ### ##### # ##### # ### #
#   #   # # #   #   # # # # #     # #   # #     # #
# ### ### ### ##### # # # # ##### # # # # # # ### #
# # #   #   # # # #     #   #     # # #     # #   #
# # # ##### ### # ### # # ### ### ############# ###
#   # #         #   # # #   #   # #   # #         #
# # # ########### ### # ### ### # # ### # # ### # #
# #         #         # # # #   #   # # # #   # # #
# ### ### ############# # # # # ##### # ######### #
# #     # #       #   # # # # # #       #     #   #
### ##### # # ### # ### # # # ### ### # # ### # ###
#   #       #   #   # #   # #   # # # # # #       #
# ### # ### ### # ### # ####### ### # ######### ###
#   # # #   #   # #   #   #     #         #     # #
### ######### ##### ### ####### ### # ##### ##### #
#   #   #   #     #   # # #     #   #       #     #
####### ### # ##### # # # # ############### # # ###
# #   #       #   # #   # # #   #       # #   #   #
# # # ##### ##### ##### # # # ### ### # # # ##### #
#   #   #   #       # #     # #   # # # # # # # # #
##### ##### # ##### # ### ### ##### ### # # # # # #
# #             # # #           #   #   #     # # #
# ### # ##### ### # ##### ### # # # # ##### ### # #
#     # # #     #   #   # # # # # #   # #   #     #
# ####### # ##### ##### # # # ### ##### ##### #####
#         # #           # #   #       #   # # #   #
# ########### # ### ### ##### # ######### # ##### #
#   # #     # # #   #   # #       # #       #     #
# # # # ##### ### ####### ####### # # ####### ### #
# #       #   # #   #   # #     # #   #   #     # #
##### ##### ### ### ### # ### ### # ### # # # # # #
# #   # #         #   #   #       # #   #   # # # #
# ##### # # ### # ### ### ### # ### ##### ### # # #
#         # #   # # # #   #   # #   #       # # # #
### # # ##### ##### # # ##### ### ### ### ### ### #
# # # # #         # # #             #   # #     # #
# ### ####### ##### ######### ##### # ##### ##### #
#       #     #         #     #     # #     #     #
# ### # ####### # ### ##### ### ### # ####### ### #
# #   #   # #   # #     # # #   #   #     # # #   #
### ####### ### ### ##### ##### # ####### # #######
# # #     #   # # #       # #   #               # #
# # ### # ### # # ### ##### # # ### # ######### # #
#   #   # #   #   #       #   # #   # #   # #     #
# ### # # # ##### ### ### # ##### # ##### # # ### #
#     # #       #   #   #       # #   #       #   #
###################################################
